tax	NORMbarcode1	NORMbarcode2	NORMbarcode3	NORMbarcode4	total
Eukaryota;Metazoa;Chordata;Mammalia;Primates;Hominidae;Homo;Homo sapiens	938991	1568742	1265960	1734720	5508413
Bacteria;Bacteria_none;Bacillota;Bacilli;Lactobacillales;Lactobacillaceae;Lactobacillus;Lactobacillus crispatus	18	54338	278	14	54648
Bacteria;Bacteria_none;Bacillota;Bacilli;Lactobacillales;Lactobacillaceae;Lactobacillus;Lactobacillus iners	3711	226	2263	257	6457
Bacteria;Bacteria_none;Actinomycetota;Actinomycetes;Bifidobacteriales;Bifidobacteriaceae;Gardnerella;Gardnerella vaginalis	91	42	820	3749	4702
Bacteria;Bacteria_none;Actinomycetota;Actinomycetes;Bifidobacteriales;Bifidobacteriaceae;Gardnerella;Gardnerella leopoldii	27	1	165	2343	2536
Bacteria;Bacteria_none;Fusobacteriota;Fusobacteriia;Fusobacteriales;Leptotrichiaceae;Sneathia;Sneathia vaginalis	0	0	0	1314	1314
Bacteria;Bacteria_none;Actinomycetota;Actinomycetes;Bifidobacteriales;Bifidobacteriaceae;Gardnerella;Gardnerella piotii	27	5	342	536	910
Bacteria;Bacteria_none;Actinomycetota;Actinomycetes;Bifidobacteriales;Bifidobacteriaceae;Gardnerella;Gardnerella swidsinskii	9	0	7	758	774
Bacteria;Bacteria_none;Bacillota;Bacilli;Lactobacillales;Lactobacillaceae;Lactobacillus;Lactobacillus jensenii	373	386	1	1	761
Bacteria;Bacteria_none;Bacteroidota;Bacteroidia;Bacteroidales;Prevotellaceae;Hoylesella;Hoylesella buccalis	2	1	1	724	728
Bacteria;Bacteria_none;Actinomycetota;Actinomycetes;Actinomycetales;Actinomycetaceae;Fannyhessea;Fannyhessea vaginae	0	0	0	467	467
Bacteria;Bacteria_none;Mycoplasmatota;Mycoplasmatota_Incertae_sedis;Mycoplasmoidales;Metamycoplasmataceae;Metamycoplasma;Metamycoplasma hominis	0	0	0	449	449
Bacteria;Bacteria_none;Bacteroidota;Bacteroidia;Bacteroidales;Prevotellaceae;Prevotella;Prevotella corporis	2	0	2	405	409
Bacteria;Bacteria_none;Bacteroidota;Bacteroidia;Bacteroidales;Prevotellaceae;Prevotella;Prevotella melaninogenica	5	0	0	330	335
Bacteria;Bacteria_none;Chlamydiota;Chlamydiia;Chlamydiales;Chlamydiaceae;Chlamydia;Chlamydia trachomatis	0	0	321	0	321
Bacteria;Bacteria_none;Bacillota;Bacilli;Lactobacillales;Lactobacillaceae;Limosilactobacillus;Limosilactobacillus portuensis	0	300	2	0	302
Bacteria;Bacteria_none;Actinomycetota;Actinomycetes;Propionibacteriales;Propionibacteriaceae;Cutibacterium;Cutibacterium acnes	92	69	75	15	251
Bacteria;Bacteria_none;Bacteroidota;Bacteroidia;Bacteroidales;Prevotellaceae;Prevotella;Prevotella intermedia	5	1	0	180	186
Eukaryota;Fungi;Ascomycota;Saccharomycetes;Saccharomycetales;Debaryomycetaceae;Candida;Candida albicans	7	158	0	0	165
Bacteria;Bacteria_none;Bacillota;Bacilli;Lactobacillales;Lactobacillaceae;Lactobacillus;Lactobacillus amylovorus	0	157	2	0	159
Bacteria;Bacteria_none;Bacillota;Bacilli;Bacillales;Staphylococcaceae;Staphylococcus;Staphylococcus aureus	89	15	38	6	148
Bacteria;Bacteria_none;Bacillota;Bacilli;Lactobacillales;Lactobacillaceae;Lactobacillus;Lactobacillus helveticus	1	146	1	0	148
Bacteria;Bacteria_none;Bacillota;Clostridia;Eubacteriales;Oscillospiraceae;Mageeibacillus;Mageeibacillus indolicus	1	0	0	135	136
Bacteria;Bacteria_none;Bacteroidota;Bacteroidia;Bacteroidales;Prevotellaceae;Prevotella;Prevotella jejuni	4	0	0	130	134
Bacteria;Bacteria_none;Bacteroidota;Bacteroidia;Bacteroidales;Prevotellaceae;Prevotella;Prevotella nigrescens	0	0	0	129	129
Bacteria;Bacteria_none;Bacteroidota;Bacteroidia;Bacteroidales;Prevotellaceae;Prevotella;Prevotella multiformis	0	0	0	99	99
Bacteria;Bacteria_none;Mycoplasmatota;Mollicutes;Mycoplasmatales;Mycoplasmataceae;Ureaplasma;Ureaplasma parvum	0	69	8	20	97
Bacteria;Bacteria_none;Pseudomonadota;Gammaproteobacteria;Enterobacterales;Enterobacteriaceae;Escherichia;Escherichia coli	26	34	20	10	90
Bacteria;Bacteria_none;Bacteroidota;Bacteroidia;Bacteroidales;Prevotellaceae;Prevotella;Prevotella denticola	1	0	0	67	68
Bacteria;Bacteria_none;Bacteroidota;Bacteroidia;Bacteroidales;Prevotellaceae;Prevotella;Prevotella histicola	1	0	0	65	66
Bacteria;Bacteria_none;Bacteroidota;Bacteroidia;Bacteroidales;Porphyromonadaceae;Porphyromonas;Porphyromonas somerae	0	0	0	64	64
Bacteria;Bacteria_none;Pseudomonadota;Gammaproteobacteria;Enterobacterales;Enterobacteriaceae;Enterobacter;Enterobacter hormaechei	9	23	5	20	57
Bacteria;Bacteria_none;Bacillota;Bacilli;Lactobacillales;Aerococcaceae;Aerococcus;Aerococcus christensenii	19	0	0	36	55
Bacteria;Bacteria_none;Bacteroidota;Bacteroidia;Bacteroidales;Prevotellaceae;Prevotella;Prevotella scopos	0	0	0	51	51
Bacteria;Bacteria_none;Bacteroidota;Bacteroidia;Bacteroidales;Prevotellaceae;Prevotella;Prevotella veroralis	0	0	0	50	50
Bacteria;Bacteria_none;Bacillota;Bacilli;Bacillales;Paenibacillaceae;Paenibacillus;Paenibacillus larvae	0	0	0	49	49
Bacteria;Bacteria_none;Bacillota;Tissierellia;Tissierellales;Peptoniphilaceae;Peptoniphilus;Peptoniphilus sp. SAHP1	3	2	0	44	49
Bacteria;Bacteria_none;Actinomycetota;Coriobacteriia;Eggerthellales;Eggerthellaceae;Gordonibacter;Gordonibacter pamelaeae	0	0	0	42	42
Bacteria;Bacteria_none;Bacteroidota;Bacteroidia;Bacteroidales;Prevotellaceae;Hoylesella;Hoylesella enoeca	0	0	0	39	39
Bacteria;Bacteria_none;Bacteroidota;Bacteroidia;Bacteroidales;Prevotellaceae;Prevotella;Prevotella sp. oral taxon 299	0	1	0	35	36
Bacteria;Bacteria_none;Bacteroidota;Bacteroidia;Bacteroidales;Prevotellaceae;Prevotella;Prevotella copri	2	0	0	31	33
Bacteria;Bacteria_none;Bacteroidota;Bacteroidia;Bacteroidales;Prevotellaceae;Prevotella;Prevotella fusca	0	0	0	33	33
Bacteria;Bacteria_none;Bacillota;Tissierellia;Tissierellales;Peptoniphilaceae;Parvimonas;Parvimonas micra	0	0	0	32	32
Bacteria;Bacteria_none;Bacteroidota;Bacteroidia;Bacteroidales;Prevotellaceae;Prevotella;Prevotella bryantii	3	0	1	27	31
Bacteria;Bacteria_none;Pseudomonadota;Gammaproteobacteria;Moraxellales;Moraxellaceae;Moraxella;Moraxella osloensis	3	16	11	0	30
Bacteria;Bacteria_none;Bacteroidota;Bacteroidia;Bacteroidales;Prevotellaceae;Prevotella;Prevotella sp. oral taxon 313	0	0	0	28	28
Bacteria;Bacteria_none;Bacillota;Bacilli;Bacillales;Staphylococcaceae;Staphylococcus;Staphylococcus epidermidis	11	4	12	1	28
Bacteria;Bacteria_none;Bacillota;Tissierellia;Tissierellales;Peptoniphilaceae;Finegoldia;Finegoldia magna	8	4	6	9	27
Bacteria;Bacteria_none;Bacillota;Bacilli;Lactobacillales;Lactobacillaceae;Limosilactobacillus;Limosilactobacillus vaginalis	0	25	0	0	25
Bacteria;Bacteria_none;Pseudomonadota;Gammaproteobacteria;Pasteurellales;Pasteurellaceae;Haemophilus;Haemophilus parainfluenzae	20	1	1	3	25
Viruses;Heunggongvirae;Uroviricota;Caudoviricetes;Caudoviricetes_Incertae_sedis;Caudoviricetes_Incertae_sedis_Incertae_sedis;Caudoviricetes_Incertae_sedis_Incertae_sedis_Incertae_sedis;Lactobacillus phage Lv-1	16	8	0	0	24
Bacteria;Bacteria_none;Bacillota;Negativicutes;Veillonellales;Veillonellaceae;Dialister;Dialister succinatiphilus	0	0	0	23	23
Bacteria;Bacteria_none;Actinomycetota;Actinomycetes;Micrococcales;Micrococcaceae;Micrococcus;Micrococcus luteus	7	9	6	0	22
Bacteria;Bacteria_none;Bacillota;Tissierellia;Tissierellales;Peptoniphilaceae;Peptoniphilus;Peptoniphilus harei	0	1	0	20	21
Bacteria;Bacteria_none;Bacteroidota;Bacteroidia;Bacteroidales;Porphyromonadaceae;Porphyromonas;Porphyromonas gingivalis	0	0	0	20	20
Bacteria;Bacteria_none;Bacillota;Bacilli;Lactobacillales;Streptococcaceae;Streptococcus;Streptococcus anginosus	4	2	0	14	20
Bacteria;Bacteria_none;Bacillota;Bacilli;Lactobacillales;Streptococcaceae;Streptococcus;Streptococcus sp. oral taxon 431	1	1	15	1	18
Bacteria;Bacteria_none;Bacteroidota;Bacteroidia;Bacteroidales;Prevotellaceae;Prevotella;Prevotella oris	0	0	1	17	18
Bacteria;Bacteria_none;Bacillota;Bacilli;Lactobacillales;Streptococcaceae;Streptococcus;Streptococcus agalactiae	0	0	0	18	18
Bacteria;Bacteria_none;Bacteroidota;Bacteroidia;Bacteroidales;Prevotellaceae;Prevotella;Prevotella herbatica	1	0	0	16	17
Bacteria;Bacteria_none;Synergistota;Synergistia;Synergistales;Aminobacteriaceae;Aminobacterium;Aminobacterium colombiense	0	17	0	0	17
Bacteria;Bacteria_none;Bacillota;Bacilli;Lactobacillales;Streptococcaceae;Streptococcus;Streptococcus pneumoniae	1	3	0	12	16
Unclassified;Unknown;Unknown;Unknown;Unknown;Unknown;Unknown;Unknown	8	5	1	1	15
Eukaryota;Fungi;Basidiomycota;Malasseziomycetes;Malasseziales;Malasseziaceae;Malassezia;Malassezia restricta	4	8	3	0	15
Bacteria;Bacteria_none;Bacillota;Negativicutes;Veillonellales;Veillonellaceae;Dialister;Dialister pneumosintes	0	0	0	15	15
Bacteria;Bacteria_none;Bacillota;Bacilli;Lactobacillales;Lactobacillaceae;Lactiplantibacillus;Lactiplantibacillus plantarum	0	14	0	0	14
Bacteria;Bacteria_none;Bacteroidota;Bacteroidia;Bacteroidales;Bacteroidaceae;Bacteroides;Bacteroides ovatus	0	0	0	14	14
Bacteria;Bacteria_none;Bacteroidota;Bacteroidia;Bacteroidales;Prevotellaceae;Prevotella;Prevotella dentalis	0	0	0	14	14
Bacteria;Bacteria_none;Bacillota;Bacilli;Bacillales;Staphylococcaceae;Staphylococcus;Staphylococcus capitis	6	2	4	1	13
Bacteria;Bacteria_none;Bacillota;Bacilli;Lactobacillales;Streptococcaceae;Streptococcus;Streptococcus mitis	8	1	2	2	13
Bacteria;Bacteria_none;Bacillota;Bacilli;Lactobacillales;Lactobacillaceae;Lactobacillus;Lactobacillus kefiranofaciens	0	13	0	0	13
Bacteria;Bacteria_none;Actinomycetota;Actinomycetes;Mycobacteriales;Corynebacteriaceae;Corynebacterium;Corynebacterium tuberculostearicum	9	0	3	0	12
Bacteria;Bacteria_none;Bacillota;Bacilli;Lactobacillales;Enterococcaceae;Enterococcus;Enterococcus mundtii	0	12	0	0	12
Bacteria;Bacteria_none;Actinomycetota;Actinomycetes;Micrococcales;Micrococcaceae;Rothia;Rothia mucilaginosa	5	0	1	5	11
Bacteria;Bacteria_none;Pseudomonadota;Gammaproteobacteria;Pseudomonadales;Pseudomonadaceae;Pseudomonas;Pseudomonas putida	1	0	2	8	11
Bacteria;Bacteria_none;Actinomycetota;Actinomycetes;Actinomycetales;Actinomycetaceae;Schaalia;Schaalia turicensis	0	0	0	11	11
Eukaryota;Fungi;Basidiomycota;Pucciniomycetes;Pucciniales;Pucciniaceae;Puccinia;Puccinia striiformis	0	2	1	8	11
Bacteria;Bacteria_none;Actinomycetota;Coriobacteriia;Eggerthellales;Eggerthellaceae;Berryella;Berryella wangjianweii	0	0	0	11	11
Bacteria;Bacteria_none;Bacillota;Bacilli;Lactobacillales;Lactobacillaceae;Limosilactobacillus;Limosilactobacillus reuteri	0	9	1	0	10
Bacteria;Bacteria_none;Bacillota;Tissierellia;Tissierellales;Peptoniphilaceae;Anaerococcus;Anaerococcus mediterraneensis	1	0	0	9	10
Bacteria;Bacteria_none;Bacillota;Bacilli;Lactobacillales;Lactobacillaceae;Lactobacillus;Lactobacillus gasseri	1	8	0	0	9
Bacteria;Bacteria_none;Pseudomonadota;Gammaproteobacteria;Enterobacterales;Enterobacteriaceae;Shigella;Shigella flexneri	0	9	0	0	9
Eukaryota;Eukaryota_Incertae_sedis;Apicomplexa;Conoidasida;Eucoccidiorida;Sarcocystidae;Toxoplasma;Toxoplasma gondii	0	4	2	3	9
Bacteria;Bacteria_none;Bacillota;Erysipelotrichia;Erysipelotrichales;Erysipelotrichaceae;Bulleidia;Bulleidia sp. zg-1006	0	0	0	8	8
Bacteria;Bacteria_none;Bacillota;Bacilli;Bacillales;Bacillales_Incertae_sedis;Gemella;Gemella haemolysans	5	3	0	0	8
Bacteria;Bacteria_none;Cyanobacteriota;Cyanophyceae;Pleurocapsales;Dermocarpellaceae;Stanieria;Stanieria cyanosphaera	0	8	0	0	8
Bacteria;Bacteria_none;Bacillota;Bacilli;Lactobacillales;Lactobacillaceae;Lactobacillus;Lactobacillus amylolyticus	0	7	1	0	8
Bacteria;Bacteria_none;Pseudomonadota;Gammaproteobacteria;Moraxellales;Moraxellaceae;Acinetobacter;Acinetobacter johnsonii	4	0	3	1	8
Bacteria;Bacteria_none;Actinomycetota;Actinomycetes;Micrococcales;Micrococcaceae;Kocuria;Kocuria rhizophila	2	0	5	0	7
Bacteria;Bacteria_none;Bacillota;Bacilli;Bacillales;Bacillaceae;Bacillus;Bacillus subtilis	0	7	0	0	7
Bacteria;Bacteria_none;Bacillota;Bacilli;Bacillales;Bacillaceae;Cytobacillus;Cytobacillus kochii	0	7	0	0	7
Bacteria;Bacteria_none;Pseudomonadota;Gammaproteobacteria;Pseudomonadales;Pseudomonadaceae;Pseudomonas;Pseudomonas fluorescens	0	0	0	7	7
Bacteria;Bacteria_none;Bacteroidota;Bacteroidia;Bacteroidales;Bacteroidaceae;Phocaeicola;Phocaeicola coprophilus	0	1	0	6	7
Bacteria;Bacteria_none;Bacillota;Bacilli;Lactobacillales;Lactobacillaceae;Lactobacillus;Lactobacillus johnsonii	0	7	0	0	7
Bacteria;Bacteria_none;Bacillota;Bacilli;Lactobacillales;Streptococcaceae;Streptococcus;Streptococcus oralis	1	3	3	0	7
Bacteria;Bacteria_none;Actinomycetota;Coriobacteriia;Eggerthellales;Eggerthellaceae;Phoenicibacter;Phoenicibacter congonensis	0	0	0	7	7
Bacteria;Bacteria_none;Bacteroidota;Bacteroidia;Bacteroidales;Tannerellaceae;Parabacteroides;Parabacteroides distasonis	0	1	0	6	7
Bacteria;Bacteria_none;Cyanobacteriota;Cyanophyceae;Pseudanabaenales;Thermosynechococcaceae;Thermosynechococcus;Thermosynechococcus sp. HN-54	0	7	0	0	7
Bacteria;Bacteria_none;Bacteroidota;Flavobacteriia;Flavobacteriales;Flavobacteriaceae;Olleya;Olleya sp. Bg11-27	0	0	1	6	7
Bacteria;Bacteria_none;Bacteroidota;Bacteroidia;Bacteroidales;Prevotellaceae;Prevotella;Prevotella sp. E2-28	0	0	0	7	7
Bacteria;Bacteria_none;Bacillota;Bacilli;Lactobacillales;Streptococcaceae;Lactococcus;Lactococcus cremoris	0	1	6	0	7
Bacteria;Bacteria_none;Bacillota;Bacilli;Lactobacillales;Streptococcaceae;Streptococcus;Streptococcus constellatus	0	0	0	6	6
Viruses;Shotokuvirae;Cossaviricota;Papovaviricetes;Zurhausenvirales;Papillomaviridae;Alphapapillomavirus;Alphapapillomavirus 10	0	0	0	6	6
Bacteria;Bacteria_none;Pseudomonadota;Betaproteobacteria;Neisseriales;Neisseriaceae;Neisseria;Neisseria sicca	6	0	0	0	6
Bacteria;Bacteria_none;Actinomycetota;Coriobacteriia;Eggerthellales;Eggerthellaceae;Berryella;Berryella intestinalis	0	0	0	6	6
Bacteria;Bacteria_none;Bacteroidota;Bacteroidia;Bacteroidales;Barnesiellaceae;Coprobacter;Coprobacter secundus	0	0	0	6	6
Bacteria;Bacteria_none;Bacteroidota;Bacteroidia;Bacteroidales;Porphyromonadaceae;Porphyromonas;Porphyromonas asaccharolytica	0	0	0	6	6
Bacteria;Bacteria_none;Actinomycetota;Actinomycetes;Candidatus Nanopelagicales;Candidatus Nanopelagicaceae;Candidatus Planktophila;Candidatus Planktophila vernalis	0	0	0	6	6
Bacteria;Bacteria_none;Pseudomonadota;Gammaproteobacteria;Pasteurellales;Pasteurellaceae;Haemophilus;Haemophilus influenzae	6	0	0	0	6
Bacteria;Bacteria_none;Bacillota;Bacilli;Lactobacillales;Streptococcaceae;Streptococcus;Streptococcus gordonii	3	0	0	3	6
Eukaryota;Fungi;Ascomycota;Sordariomycetes;Hypocreales;Nectriaceae;Fusarium;Fusarium poae	2	2	0	2	6
Bacteria;Bacteria_none;Bacillota;Bacilli;Lactobacillales;Lactobacillaceae;Lactobacillus;Lactobacillus acidophilus	0	6	0	0	6
Bacteria;Bacteria_none;Bacillota;Bacilli;Lactobacillales;Streptococcaceae;Streptococcus;Streptococcus sp. oral taxon 061	1	0	0	5	6
Bacteria;Bacteria_none;Bacillota;Clostridia;Eubacteriales;Clostridiaceae;Clostridium;Clostridium perfringens	0	0	0	6	6
Bacteria;Bacteria_none;Bacillota;Clostridia;Eubacteriales;Eubacteriales Family XIII. Incertae Sedis;Mogibacterium;Mogibacterium diversum	0	0	0	6	6
Bacteria;Bacteria_none;Bacillota;Bacilli;Lactobacillales;Carnobacteriaceae;Granulicatella;Granulicatella elegans	0	0	1	5	6
Bacteria;Bacteria_none;Actinomycetota;Actinomycetes;Actinomycetales;Actinomycetaceae;Winkia;Winkia neuii	2	0	4	0	6
Bacteria;Bacteria_none;Bacillota;Clostridia;Eubacteriales;Clostridiaceae;Clostridium;Clostridium estertheticum	0	0	1	4	5
Bacteria;Bacteria_none;Bacillota;Bacilli;Lactobacillales;Lactobacillaceae;Companilactobacillus;Companilactobacillus zhachilii	0	0	0	5	5
Bacteria;Bacteria_none;Bacillota;Bacilli;Bacillales;Bacillaceae;Bacillus;Bacillus velezensis	0	2	0	3	5
Bacteria;Bacteria_none;Bacteroidota;Flavobacteriia;Flavobacteriales;Flavobacteriaceae;Lutibacter;Lutibacter sp. A80	0	0	0	5	5
Eukaryota;Eukaryota_Incertae_sedis;Eukaryota_Incertae_sedis_Incertae_sedis;Cryptophyceae;Cryptomonadales;Cryptomonadaceae;Cryptomonas;Cryptomonas paramecium	0	1	3	1	5
Bacteria;Bacteria_none;Bacteroidota;Flavobacteriia;Flavobacteriales;Weeksellaceae;Chryseobacterium;Chryseobacterium sp. MEBOG07	0	0	1	4	5
Bacteria;Bacteria_none;Bacteroidota;Sphingobacteriia;Sphingobacteriales;Sphingobacteriaceae;Pedobacter;Pedobacter ginsengisoli	0	0	0	5	5
Bacteria;Bacteria_none;Bacteroidota;Bacteroidia;Bacteroidales;Prevotellaceae;Prevotella;Prevotella sp. Rep29	0	0	0	5	5
Bacteria;Bacteria_none;Actinomycetota;Actinomycetes;Bifidobacteriales;Bifidobacteriaceae;Bifidobacterium;Bifidobacterium longum	0	0	0	5	5
Bacteria;Bacteria_none;Pseudomonadota;Deltaproteobacteria;Desulfovibrionales;Desulfovibrionaceae;Lawsonia;Lawsonia intracellularis	0	5	0	0	5
Bacteria;Bacteria_none;Pseudomonadota;Alphaproteobacteria;Rhodobacterales;Paracoccaceae;Paracoccus;Paracoccus yeei	0	3	2	0	5
Bacteria;Bacteria_none;Bacteroidota;Flavobacteriia;Flavobacteriales;Blattabacteriaceae;Blattabacterium;Blattabacterium cuenoti	1	0	0	4	5
Bacteria;Bacteria_none;Pseudomonadota;Alphaproteobacteria;Hyphomicrobiales;Nitrobacteraceae;Bradyrhizobium;Bradyrhizobium sp. CCBAU 53340	0	0	0	4	4
Bacteria;Bacteria_none;Bacillota;Bacilli;Lactobacillales;Streptococcaceae;Streptococcus;Streptococcus sanguinis	0	1	2	1	4
Bacteria;Bacteria_none;Cyanobacteriota;Cyanophyceae;Nostocales;Aphanizomenonaceae;Anabaenopsis;Anabaenopsis circularis	0	0	0	4	4
Bacteria;Bacteria_none;Cyanobacteriota;Cyanophyceae;Pseudanabaenales;Pseudanabaenaceae;Pseudanabaena;Pseudanabaena sp. Chao 1811	0	0	0	4	4
Bacteria;Bacteria_none;Bacillota;Bacilli;Lactobacillales;Lactobacillaceae;Ligilactobacillus;Ligilactobacillus salivarius	0	1	0	3	4
Bacteria;Bacteria_none;Bacillota;Bacilli;Lactobacillales;Lactobacillaceae;Lactobacillus;Lactobacillus sp. PV037	0	4	0	0	4
Bacteria;Bacteria_none;Fusobacteriota;Fusobacteriia;Fusobacteriales;Leptotrichiaceae;Leptotrichia;Leptotrichia hongkongensis	0	0	1	3	4
Bacteria;Bacteria_none;Actinomycetota;Actinomycetes;Mycobacteriales;Corynebacteriaceae;Corynebacterium;Corynebacterium kefirresidentii	3	0	1	0	4
Bacteria;Bacteria_none;Bacillota;Bacilli;Lactobacillales;Streptococcaceae;Streptococcus;Streptococcus sp. LPB0220	3	0	0	1	4
Bacteria;Bacteria_none;Pseudomonadota;Gammaproteobacteria;Enterobacterales;Enterobacteriaceae;Enterobacter;Enterobacter cloacae	0	0	0	4	4
Bacteria;Bacteria_none;Actinomycetota;Coriobacteriia;Eggerthellales;Eggerthellaceae;Eggerthella;Eggerthella sp. YY7918	0	0	0	4	4
Bacteria;Bacteria_none;Pseudomonadota;Gammaproteobacteria;Enterobacterales;Enterobacteriaceae;Salmonella;Salmonella enterica	0	0	4	0	4
Bacteria;Bacteria_none;Pseudomonadota;Gammaproteobacteria;Xanthomonadales;Xanthomonadaceae;Stenotrophomonas;Stenotrophomonas maltophilia	3	0	0	1	4
Eukaryota;Eukaryota_Incertae_sedis;Apicomplexa;Aconoidasida;Haemosporida;Plasmodiidae;Plasmodium;Plasmodium relictum	1	2	0	1	4
Eukaryota;Eukaryota_Incertae_sedis;Apicomplexa;Aconoidasida;Haemosporida;Plasmodiidae;Plasmodium;Plasmodium vinckei	2	1	0	1	4
Bacteria;Bacteria_none;Bacillota;Bacilli;Bacillales;Bacillales_Incertae_sedis;Gemella;Gemella sanguinis	2	0	0	2	4
Bacteria;Bacteria_none;Pseudomonadota;Betaproteobacteria;Burkholderiales;Burkholderiaceae;Paraburkholderia;Paraburkholderia edwinii	1	0	0	3	4
Bacteria;Bacteria_none;Bacillota;Bacilli;Lactobacillales;Streptococcaceae;Lactococcus;Lactococcus garvieae	0	0	0	4	4
Viruses;Shotokuvirae;Cossaviricota;Papovaviricetes;Zurhausenvirales;Papillomaviridae;Alphapapillomavirus;Alphapapillomavirus 14	0	4	0	0	4
Bacteria;Bacteria_none;Bacillota;Negativicutes;Veillonellales;Veillonellaceae;Megasphaera;Megasphaera stantonii	0	0	0	4	4
Bacteria;Bacteria_none;Bacillota;Clostridia;Eubacteriales;Eubacteriales_Incertae_sedis;Fenollaria;Fenollaria sporofastidiosus	0	0	0	4	4
Bacteria;Bacteria_none;Bacillota;Negativicutes;Veillonellales;Veillonellaceae;Veillonella;Veillonella atypica	1	2	0	1	4
Bacteria;Bacteria_none;Bacteroidota;Bacteroidia;Bacteroidales;Odoribacteraceae;Butyricimonas;Butyricimonas faecalis	0	0	0	4	4
Bacteria;Bacteria_none;Bacteroidota;Bacteroidia;Bacteroidales;Bacteroidaceae;Bacteroides;Bacteroides nordii	0	2	0	2	4
Bacteria;Bacteria_none;Bacillota;Clostridia;Eubacteriales;Clostridiaceae;Clostridium;Clostridium butyricum	0	0	0	4	4
Bacteria;Bacteria_none;Bacillota;Clostridia;Eubacteriales;Oscillospiraceae;Fastidiosipila;Fastidiosipila sanguinis	2	0	0	2	4
Bacteria;Bacteria_none;Bacteroidota;Cytophagia;Cytophagales;Hymenobacteraceae;Pontibacter;Pontibacter sp. SGAir0037	0	0	1	3	4
Bacteria;Bacteria_none;Bacteroidota;Bacteroidia;Bacteroidales;Rikenellaceae;Alistipes;Alistipes finegoldii	0	0	0	4	4
Bacteria;Bacteria_none;Bacteroidota;Bacteroidia;Bacteroidales;Bacteroidaceae;Bacteroides;Bacteroides coprosuis	0	0	0	4	4
Bacteria;Bacteria_none;Bacillota;Bacillota_Incertae_sedis;Bacillota_Incertae_sedis_Incertae_sedis;Bacillota_Incertae_sedis_Incertae_sedis_Incertae_sedis;Ndongobacter;Ndongobacter massiliensis	0	0	0	4	4
Bacteria;Bacteria_none;Pseudomonadota;Gammaproteobacteria;Enterobacterales;Morganellaceae;Providencia;Providencia stuartii	0	0	0	3	3
Bacteria;Bacteria_none;Bacillota;Negativicutes;Veillonellales;Veillonellaceae;Megasphaera;Megasphaera elsdenii	0	1	0	2	3
Bacteria;Bacteria_none;Bacillota;Negativicutes;Veillonellales;Veillonellaceae;Veillonella;Veillonella rogosae	0	0	0	3	3
Bacteria;Bacteria_none;Pseudomonadota;Gammaproteobacteria;Enterobacterales;Enterobacteriaceae;Citrobacter;Citrobacter freundii	0	0	0	3	3
Bacteria;Bacteria_none;Pseudomonadota;Gammaproteobacteria;Enterobacterales;Morganellaceae;Providencia;Providencia alcalifaciens	0	2	0	1	3
Bacteria;Bacteria_none;Bacteroidota;Bacteroidia;Bacteroidales;Prevotellaceae;Prevotella;Prevotella sp. E13-17	0	0	0	3	3
Bacteria;Bacteria_none;Bacillota;Bacilli;Lactobacillales;Enterococcaceae;Enterococcus;Enterococcus faecium	0	0	1	2	3
Bacteria;Bacteria_none;Pseudomonadota;Epsilonproteobacteria;Campylobacterales;Campylobacteraceae;Campylobacter;Campylobacter peloridis	0	0	0	3	3
Bacteria;Bacteria_none;Spirochaetota;Spirochaetia;Brachyspirales;Brachyspiraceae;Brachyspira;Brachyspira pilosicoli	0	0	0	3	3
Bacteria;Bacteria_none;Bacillota;Bacilli;Bacillales;Staphylococcaceae;Staphylococcus;Staphylococcus saccharolyticus	2	0	1	0	3
Bacteria;Bacteria_none;Bacteroidota;Bacteroidia;Bacteroidales;Bacteroidaceae;Bacteroides;Bacteroides fragilis	0	0	0	3	3
Bacteria;Bacteria_none;Bacillota;Bacilli;Bacillales;Staphylococcaceae;Mammaliicoccus;Mammaliicoccus vitulinus	0	0	0	3	3
Eukaryota;Fungi;Ascomycota;Sordariomycetes;Hypocreales;Nectriaceae;Fusarium;Fusarium fujikuroi	0	0	3	0	3
Bacteria;Bacteria_none;Bacillota;Bacilli;Bacillales;Listeriaceae;Listeria;Listeria welshimeri	0	0	0	3	3
Bacteria;Bacteria_none;Bacillota;Bacilli;Bacillales;Bacillales_Incertae_sedis;Gemella;Gemella sp. oral taxon 928	0	0	0	3	3
Eukaryota;Fungi;Ascomycota;Sordariomycetes;Hypocreales;Nectriaceae;Fusarium;Fusarium keratoplasticum	0	2	0	1	3
Eukaryota;Fungi;Basidiomycota;Agaricomycetes;Agaricales;Marasmiaceae;Marasmius;Marasmius oreades	2	0	1	0	3
Bacteria;Bacteria_none;Pseudomonadota;Gammaproteobacteria;Alteromonadales;Pseudoalteromonadaceae;Pseudoalteromonas;Pseudoalteromonas rubra	2	0	1	0	3
Bacteria;Bacteria_none;Bacteroidota;Flavobacteriia;Flavobacteriales;Flavobacteriaceae;Polaribacter;Polaribacter pectinis	0	0	0	3	3
Bacteria;Bacteria_none;Pseudomonadota;Deltaproteobacteria;Desulfovibrionales;Desulfovibrionaceae;Pseudodesulfovibrio;Pseudodesulfovibrio piezophilus	0	0	0	3	3
Bacteria;Bacteria_none;Bacteroidota;Flavobacteriia;Flavobacteriales;Flavobacteriaceae;Flavobacterium;Flavobacterium sp. N2038	0	3	0	0	3
Bacteria;Bacteria_none;Bacillota;Bacilli;Lactobacillales;Streptococcaceae;Streptococcus;Streptococcus salivarius	1	0	0	2	3
Bacteria;Bacteria_none;Bacillota;Bacilli;Lactobacillales;Streptococcaceae;Streptococcus;Streptococcus pyogenes	0	2	0	1	3
Bacteria;Bacteria_none;Bacillota;Bacilli;Lactobacillales;Streptococcaceae;Streptococcus;Streptococcus porcinus	0	0	0	3	3
Bacteria;Bacteria_none;Bacteroidota;Flavobacteriia;Flavobacteriales;Flavobacteriaceae;Tenacibaculum;Tenacibaculum sp. SZ-18	0	0	0	3	3
Bacteria;Bacteria_none;Bacteroidota;Flavobacteriia;Flavobacteriales;Flavobacteriaceae;Winogradskyella;Winogradskyella forsetii	1	0	0	2	3
Bacteria;Bacteria_none;Bacillota;Clostridia;Eubacteriales;Clostridiaceae;Clostridium;Clostridium beijerinckii	0	1	0	2	3
Bacteria;Bacteria_none;Bacteroidota;Flavobacteriia;Flavobacteriales;Weeksellaceae;Empedobacter;Empedobacter falsenii	0	3	0	0	3
Bacteria;Bacteria_none;Bacteroidota;Flavobacteriia;Flavobacteriales;Weeksellaceae;Ornithobacterium;Ornithobacterium rhinotracheale	0	0	1	2	3
Bacteria;Bacteria_none;Chloroflexota;Chloroflexia;Chloroflexales;Chloroflexaceae;Chloroflexus;Chloroflexus aurantiacus	0	0	0	3	3
Bacteria;Bacteria_none;Bacteroidota;Bacteroidia;Bacteroidales;Bacteroidaceae;Bacteroides;Bacteroides cellulosilyticus	0	0	0	3	3
Bacteria;Bacteria_none;Bacteroidota;Bacteroidia;Bacteroidales;Prevotellaceae;Prevotella;Prevotella sp. oral taxon 475	0	0	0	3	3
Bacteria;Bacteria_none;Cyanobacteriota;Cyanophyceae;Nostocales;Rivulariaceae;Rivularia;Rivularia sp. PCC 7116	0	0	0	3	3
Bacteria;Bacteria_none;Bacteroidota;Flavobacteriia;Flavobacteriales;Flavobacteriaceae;Flavobacterium;Flavobacterium sp. N1846	1	0	0	2	3
Bacteria;Bacteria_none;Cyanobacteriota;Cyanophyceae;Synechococcales;Prochlorococcaceae;Prochlorococcus;Prochlorococcus marinus	0	1	1	1	3
Bacteria;Bacteria_none;Cyanobacteriota;Cyanophyceae;Synechococcales;Synechococcaceae;Synechococcus;Synechococcus sp. PCC 7502	0	0	0	3	3
Bacteria;Bacteria_none;Bacteroidota;Flavobacteriia;Flavobacteriales;Flavobacteriaceae;Flavobacterium;Flavobacterium sp. 140616W15	0	0	0	3	3
Bacteria;Bacteria_none;Bacillota;Clostridia;Eubacteriales;Lachnospiraceae;Lachnoanaerobaculum;Lachnoanaerobaculum umeaense	0	1	0	2	3
Bacteria;Bacteria_none;Mycoplasmatota;Mollicutes;Mycoplasmatales;Mycoplasmataceae;Ureaplasma;Ureaplasma urealyticum	0	2	0	1	3
Bacteria;Bacteria_none;Pseudomonadota;Alphaproteobacteria;Hyphomicrobiales;Methylobacteriaceae;Methylorubrum;Methylorubrum extorquens	2	0	1	0	3
Bacteria;Bacteria_none;Bacillota;Bacilli;Lactobacillales;Lactobacillaceae;Lactobacillus;Lactobacillus delbrueckii	0	1	2	0	3
Bacteria;Bacteria_none;Pseudomonadota;Betaproteobacteria;Nitrosomonadales;Methylophilaceae;Methyloradius;Methyloradius palustris	0	0	0	3	3
Archaea;Archaea_none;Crenarchaeota;Thermoprotei;Acidilobales;Caldisphaeraceae;Caldisphaera;Caldisphaera lagunensis	0	0	0	3	3
Bacteria;Bacteria_none;Actinomycetota;Actinomycetes;Propionibacteriales;Propionibacteriaceae;Vaginimicrobium;Vaginimicrobium propionicum	0	0	0	3	3
Bacteria;Bacteria_none;Actinomycetota;Rubrobacteria;Rubrobacterales;Baekduiaceae;Baekduia;Baekduia sp. 0141_2	0	3	0	0	3
Bacteria;Bacteria_none;Actinomycetota;Coriobacteriia;Eggerthellales;Eggerthellaceae;Eggerthella;Eggerthella lenta	0	0	0	3	3
Bacteria;Bacteria_none;Actinomycetota;Actinomycetes;Mycobacteriales;Corynebacteriaceae;Corynebacterium;Corynebacterium diphtheriae	0	0	3	0	3
Archaea;Archaea_none;Euryarchaeota;Methanomicrobia;Methanosarcinales;Methanosarcinaceae;Methanosarcina;Methanosarcina barkeri	0	1	0	2	3
Bacteria;Bacteria_none;Actinomycetota;Actinomycetes;Mycobacteriales;Corynebacteriaceae;Corynebacterium;Corynebacterium glucuronolyticum	2	1	0	0	3
Bacteria;Bacteria_none;Actinomycetota;Actinomycetes;Propionibacteriales;Propionibacteriaceae;Cutibacterium;Cutibacterium granulosum	0	2	1	0	3
Bacteria;Bacteria_none;Actinomycetota;Coriobacteriia;Eggerthellales;Eggerthellaceae;Cryptobacterium;Cryptobacterium curtum	0	0	0	3	3
Bacteria;Bacteria_none;Bacillota;Clostridia;Eubacteriales;Clostridiaceae;Clostridium;Clostridium argentinense	0	0	0	2	2
Bacteria;Bacteria_none;Pseudomonadota;Gammaproteobacteria;Nevskiales;Steroidobacteraceae;Steroidobacter;Steroidobacter denitrificans	1	0	0	1	2
Bacteria;Bacteria_none;Pseudomonadota;Gammaproteobacteria;Moraxellales;Moraxellaceae;Psychrobacter;Psychrobacter arenosus	0	1	1	0	2
Bacteria;Bacteria_none;Bacillota;Bacilli;Lactobacillales;Streptococcaceae;Streptococcus;Streptococcus suis	0	2	0	0	2
Bacteria;Bacteria_none;Bacteroidota;Flavobacteriia;Flavobacteriales;Flavobacteriaceae;Flavobacterium;Flavobacterium sp. IMCC36791	1	0	1	0	2
Bacteria;Bacteria_none;Actinomycetota;Actinomycetes;Propionibacteriales;Kribbellaceae;Kribbella;Kribbella sp. CA-293567	0	0	0	2	2
Bacteria;Bacteria_none;Bacillota;Bacilli;Lactobacillales;Streptococcaceae;Streptococcus;Streptococcus sp. NPS 308	1	1	0	0	2
Bacteria;Bacteria_none;Bacillota;Bacilli;Lactobacillales;Streptococcaceae;Streptococcus;Streptococcus sp. Marseille-Q6470	1	0	0	1	2
Bacteria;Bacteria_none;Actinomycetota;Actinomycetes;Mycobacteriales;Nocardiaceae;Rhodococcus;Rhodococcus sp. P-2	2	0	0	0	2
Bacteria;Bacteria_none;Pseudomonadota;Alphaproteobacteria;Sphingomonadales;Sphingomonadaceae;Aquisediminimonas;Aquisediminimonas profunda	0	0	0	2	2
Bacteria;Bacteria_none;Pseudomonadota;Gammaproteobacteria;Moraxellales;Moraxellaceae;Acinetobacter;Acinetobacter wuhouensis	0	0	0	2	2
Bacteria;Bacteria_none;Bacteroidota;Flavobacteriia;Flavobacteriales;Flavobacteriaceae;Flavobacterium;Flavobacterium nitrogenifigens	0	0	0	2	2
Bacteria;Bacteria_none;Bacillota;Clostridia;Eubacteriales;Clostridiaceae;Clostridium;Clostridium chauvoei	0	0	2	0	2
Bacteria;Bacteria_none;Pseudomonadota;Betaproteobacteria;Burkholderiales;Burkholderiaceae;Burkholderia;Burkholderia cenocepacia	0	0	2	0	2
Bacteria;Bacteria_none;Bacillota;Clostridia;Eubacteriales;Clostridiaceae;Clostridium;Clostridium manihotivorum	0	1	0	1	2
Bacteria;Bacteria_none;Bacteroidota;Flavobacteriia;Flavobacteriales;Flavobacteriaceae;Flavobacterium;Flavobacterium crocinum	0	0	2	0	2
Bacteria;Bacteria_none;Pseudomonadota;Betaproteobacteria;Burkholderiales;Burkholderiaceae;Burkholderia;Burkholderia glumae	0	0	2	0	2
Bacteria;Bacteria_none;Bacteroidota;Flavobacteriia;Flavobacteriales;Flavobacteriaceae;Flavobacterium;Flavobacterium azooxidireducens	0	1	0	1	2
Bacteria;Bacteria_none;Bacillota;Clostridia;Eubacteriales;Clostridiaceae;Clostridium;Clostridium sp. JN-1	0	0	1	1	2
Bacteria;Bacteria_none;Bacillota;Clostridia;Eubacteriales;Clostridiaceae;Clostridium;Clostridium tyrobutyricum	0	0	0	2	2
Bacteria;Bacteria_none;Bacteroidota;Flavobacteriia;Flavobacteriales;Flavobacteriaceae;Flavivirga;Flavivirga eckloniae	0	0	0	2	2
Bacteria;Bacteria_none;Pseudomonadota;Gammaproteobacteria;Legionellales;Coxiellaceae;Rickettsiella;Candidatus Rickettsiella viridis	0	0	0	2	2
Bacteria;Bacteria_none;Bacillota;Bacilli;Lactobacillales;Streptococcaceae;Streptococcus;Streptococcus sp. Marseille-Q3533	0	0	0	2	2
Bacteria;Bacteria_none;Pseudomonadota;Gammaproteobacteria;Pasteurellales;Pasteurellaceae;Actinobacillus;Actinobacillus pleuropneumoniae	0	0	0	2	2
Bacteria;Bacteria_none;Bacteroidota;Flavobacteriia;Flavobacteriales;Flavobacteriaceae;Flavobacterium;Flavobacterium sp. KACC 22763	0	0	0	2	2
Bacteria;Bacteria_none;Pseudomonadota;Gammaproteobacteria;Oceanospirillales;Halomonadaceae;Halomonas;Halomonas sp. HG01	0	0	2	0	2
Bacteria;Bacteria_none;Pseudomonadota;Gammaproteobacteria;Vibrionales;Vibrionaceae;Vibrio;Vibrio aquimaris	1	1	0	0	2
Bacteria;Bacteria_none;Bacteroidota;Flavobacteriia;Flavobacteriales;Weeksellaceae;Chryseobacterium;Chryseobacterium carnipullorum	0	0	0	2	2
Bacteria;Bacteria_none;Pseudomonadota;Alphaproteobacteria;Rhodobacterales;Paracoccaceae;Paracoccus;Paracoccus zhejiangensis	0	0	0	2	2
Bacteria;Bacteria_none;Bacteroidota;Flavobacteriia;Flavobacteriales;Schleiferiaceae;Owenweeksia;Owenweeksia hongkongensis	0	0	0	2	2
Bacteria;Bacteria_none;Bacillota;Bacilli;Lactobacillales;Lactobacillaceae;Limosilactobacillus;Limosilactobacillus frumenti	0	2	0	0	2
Bacteria;Bacteria_none;Bacteroidota;Flavobacteriia;Flavobacteriales;Flavobacteriaceae;Winogradskyella;Winogradskyella sp. MH6	0	1	0	1	2
Bacteria;Bacteria_none;Actinomycetota;Actinomycetes;Kitasatosporales;Streptomycetaceae;Streptomyces;Streptomyces venezuelae	0	0	0	2	2
Bacteria;Bacteria_none;Bacteroidota;Flavobacteriia;Flavobacteriales;Flavobacteriaceae;Tenacibaculum;Tenacibaculum pacificus	0	1	1	0	2
Bacteria;Bacteria_none;Bacteroidota;Flavobacteriia;Flavobacteriales;Flavobacteriaceae;Siansivirga;Siansivirga zeaxanthinifaciens	0	0	0	2	2
Bacteria;Bacteria_none;Bacillota;Bacilli;Lactobacillales;Lactobacillaceae;Pediococcus;Pediococcus claussenii	0	0	0	2	2
Bacteria;Bacteria_none;Bacillota;Bacilli;Lactobacillales;Streptococcaceae;Lactococcus;Lactococcus lactis	0	0	2	0	2
Bacteria;Bacteria_none;Pseudomonadota;Gammaproteobacteria;Pseudomonadales;Pseudomonadaceae;Pseudomonas;Pseudomonas sp. ABC1	0	2	0	0	2
Bacteria;Bacteria_none;Pseudomonadota;Alphaproteobacteria;Rickettsiales;Anaplasmataceae;Wolbachia;Candidatus Wolbachia massiliensis	0	0	0	2	2
Bacteria;Bacteria_none;Actinomycetota;Actinomycetes;Propionibacteriales;Propionibacteriaceae;Cutibacterium;Cutibacterium modestum	0	0	2	0	2
Bacteria;Bacteria_none;Bacteroidota;Flavobacteriia;Flavobacteriales;Flavobacteriaceae;Lacinutrix;Lacinutrix sp. Bg11-31	0	0	0	2	2
Bacteria;Bacteria_none;Bacillota;Bacilli;Lactobacillales;Streptococcaceae;Streptococcus;Streptococcus parasanguinis	0	0	1	1	2
Bacteria;Bacteria_none;Bacteroidota;Flavobacteriia;Flavobacteriales;Flavobacteriaceae;Flavobacterium;Flavobacterium sp. N502540	0	0	0	2	2
Bacteria;Bacteria_none;Actinomycetota;Actinomycetes;Actinomycetales;Actinomycetaceae;Actinomyces;Actinomyces oris	2	0	0	0	2
Bacteria;Bacteria_none;Actinomycetota;Actinomycetes;Actinomycetales;Actinomycetaceae;Arcanobacterium;Arcanobacterium haemolyticum	0	0	0	2	2
Bacteria;Bacteria_none;Pseudomonadota;Gammaproteobacteria;Pasteurellales;Pasteurellaceae;Haemophilus;Haemophilus haemolyticus	1	1	0	0	2
Bacteria;Bacteria_none;Bacillota;Clostridia;Eubacteriales;Eubacteriales Family XIII. Incertae Sedis;Emergencia;Emergencia timonensis	0	0	0	2	2
Bacteria;Bacteria_none;Pseudomonadota;Gammaproteobacteria;Enterobacterales;Pectobacteriaceae;Pectobacterium;Pectobacterium parvum	0	0	0	2	2
Bacteria;Bacteria_none;Actinomycetota;Actinomycetes;Bifidobacteriales;Bifidobacteriaceae;Bifidobacterium;Bifidobacterium adolescentis	0	0	0	2	2
Bacteria;Bacteria_none;Pseudomonadota;Gammaproteobacteria;Enterobacterales;Morganellaceae;Providencia;Providencia sp. R33	2	0	0	0	2
Bacteria;Bacteria_none;Bacillota;Tissierellia;Tissierellales;Peptoniphilaceae;Anaerococcus;Anaerococcus vaginalis	0	1	1	0	2
Bacteria;Bacteria_none;Actinomycetota;Actinomycetes;Mycobacteriales;Corynebacteriaceae;Corynebacterium;Corynebacterium provencense	0	0	0	2	2
Bacteria;Bacteria_none;Actinomycetota;Actinomycetes;Micrococcales;Microbacteriaceae;Curtobacterium;Curtobacterium luteum	0	2	0	0	2
Bacteria;Bacteria_none;Bacillota;Tissierellia;Tissierellia_Incertae_sedis;Tissierellia_Incertae_sedis_Incertae_sedis;Ezakiella;Ezakiella massiliensis	0	0	0	2	2
Bacteria;Bacteria_none;Actinomycetota;Actinomycetes;Mycobacteriales;Corynebacteriaceae;Corynebacterium;Corynebacterium kroppenstedtii	1	0	1	0	2
Bacteria;Bacteria_none;Actinomycetota;Actinomycetes;Mycobacteriales;Corynebacteriaceae;Corynebacterium;Corynebacterium jeikeium	0	0	1	1	2
Bacteria;Bacteria_none;Pseudomonadota;Gammaproteobacteria;Alteromonadales;Alteromonadaceae;Catenovulum;Catenovulum sediminis	0	0	0	2	2
Bacteria;Bacteria_none;Bacteroidota;Bacteroidia;Bacteroidales;Bacteroidaceae;Bacteroides;Bacteroides heparinolyticus	0	0	0	2	2
Bacteria;Bacteria_none;Bacteroidota;Bacteroidia;Bacteroidales;Bacteroidaceae;Bacteroides;Bacteroides intestinalis	0	0	0	2	2
Bacteria;Bacteria_none;Bacteroidota;Bacteroidia;Bacteroidales;Bacteroidaceae;Bacteroides;Bacteroides salyersiae	0	0	1	1	2
Bacteria;Bacteria_none;Pseudomonadota;Deltaproteobacteria;Desulfovibrionales;Desulfovibrionaceae;Megalodesulfovibrio;Megalodesulfovibrio gigas	2	0	0	0	2
Bacteria;Bacteria_none;Bacteroidota;Bacteroidia;Bacteroidales;Bacteroidaceae;Bacteroides;Bacteroides zhangwenhongii	2	0	0	0	2
Bacteria;Bacteria_none;Pseudomonadota;Gammaproteobacteria;Aeromonadales;Aeromonadaceae;Aeromonas;Aeromonas caviae	0	0	0	2	2
Bacteria;Bacteria_none;Pseudomonadota;Epsilonproteobacteria;Campylobacterales;Helicobacteraceae;Helicobacter;Helicobacter acinonychis	0	0	0	2	2
Bacteria;Bacteria_none;Actinomycetota;Actinomycetes;Mycobacteriales;Corynebacteriaceae;Corynebacterium;Corynebacterium callunae	0	0	0	2	2
Bacteria;Bacteria_none;Pseudomonadota;Epsilonproteobacteria;Campylobacterales;Campylobacteraceae;Campylobacter;Campylobacter volucris	0	0	0	2	2
Bacteria;Bacteria_none;Bacteroidota;Bacteroidia;Bacteroidales;Paludibacteraceae;Paludibacter;Paludibacter propionicigenes	1	0	0	1	2
Bacteria;Bacteria_none;Bacteroidota;Bacteroidia;Bacteroidales;Prevotellaceae;Prevotella;Prevotella ruminicola	0	0	0	2	2
Bacteria;Bacteria_none;Pseudomonadota;Epsilonproteobacteria;Campylobacterales;Campylobacteraceae;Campylobacter;Campylobacter upsaliensis	0	1	1	0	2
Bacteria;Bacteria_none;Pseudomonadota;Epsilonproteobacteria;Campylobacterales;Campylobacteraceae;Campylobacter;Campylobacter sputorum	2	0	0	0	2
Bacteria;Bacteria_none;Actinomycetota;Actinomycetes;Micrococcales;Microbacteriaceae;Microbacterium;Microbacterium sp. nov. GSS16	0	0	2	0	2
Bacteria;Bacteria_none;Pseudomonadota;Deltaproteobacteria;Myxococcales;Myxococcaceae;Corallococcus;Corallococcus sp. NCRR	1	1	0	0	2
Bacteria;Bacteria_none;Pseudomonadota;Deltaproteobacteria;Myxococcales;Myxococcaceae;Pyxidicoccus;Pyxidicoccus sp. SCPEA002	0	1	1	0	2
Bacteria;Bacteria_none;Pseudomonadota;Deltaproteobacteria;Myxococcales;Sandaracinaceae;Sandaracinus;Sandaracinus amylolyticus	1	0	0	1	2
Bacteria;Bacteria_none;Bacillota;Tissierellia;Tissierellales;Peptoniphilaceae;Peptoniphilus;Peptoniphilus asaccharolyticus	0	0	0	2	2
Bacteria;Bacteria_none;Bacillota;Tissierellia;Tissierellales;Peptoniphilaceae;Anaerococcus;Anaerococcus prevotii	0	0	0	2	2
Bacteria;Bacteria_none;Pseudomonadota;Gammaproteobacteria;Vibrionales;Vibrionaceae;Vibrio;Vibrio parahaemolyticus	0	0	0	2	2
Bacteria;Bacteria_none;Bacillota;Tissierellia;Tissierellales;Gottschalkiaceae;Gottschalkia;Gottschalkia acidurici	0	0	1	1	2
Bacteria;Bacteria_none;Bacteroidota;Flavobacteriia;Flavobacteriales;Flavobacteriaceae;Aquimarina;Aquimarina sp. TRL1	0	1	0	1	2
Bacteria;Bacteria_none;Pseudomonadota;Betaproteobacteria;Burkholderiales;Burkholderiaceae;Lautropia;Lautropia mirabilis	2	0	0	0	2
Bacteria;Bacteria_none;Pseudomonadota;Gammaproteobacteria;Enterobacterales;Erwiniaceae;Pantoea;Pantoea agglomerans	1	0	1	0	2
Bacteria;Bacteria_none;Pseudomonadota;Gammaproteobacteria;Enterobacterales;Erwiniaceae;Erwinia;Candidatus Erwinia haradaeae	0	0	0	2	2
Bacteria;Bacteria_none;Bacillota;Clostridia;Eubacteriales;Lachnospiraceae;Mediterraneibacter;[Ruminococcus] lactaris	0	0	0	2	2
Bacteria;Bacteria_none;Pseudomonadota;Gammaproteobacteria;Enterobacterales;Erwiniaceae;Buchnera;Buchnera aphidicola	1	1	0	0	2
Bacteria;Bacteria_none;Bacillota;Clostridia;Eubacteriales;Lachnospiraceae;Simiaoa;Simiaoa sunii	0	0	0	2	2
Bacteria;Bacteria_none;Bacillota;Clostridia;Eubacteriales;Oscillospiraceae;Acetivibrio;Acetivibrio thermocellus	0	0	0	2	2
Bacteria;Bacteria_none;Actinomycetota;Actinomycetes;Micrococcales;Dermabacteraceae;Dermabacter;Dermabacter jinjuensis	0	0	0	2	2
Bacteria;Bacteria_none;Actinomycetota;Actinomycetes;Mycobacteriales;Mycobacteriaceae;Mycobacterium;Mycobacterium rufum	1	0	1	0	2
Bacteria;Bacteria_none;Pseudomonadota;Gammaproteobacteria;Enterobacterales;Enterobacteriaceae;Klebsiella;Klebsiella michiganensis	0	0	2	0	2
Bacteria;Bacteria_none;Bacillota;Clostridia;Eubacteriales;Oscillospiraceae;Ruminiclostridium;Ruminiclostridium herbifermentans	0	0	0	2	2
Bacteria;Bacteria_none;Bacillota;Clostridia;Eubacteriales;Peptostreptococcaceae;Clostridioides;Clostridioides difficile	0	0	0	2	2
Bacteria;Bacteria_none;Pseudomonadota;Betaproteobacteria;Burkholderiales;Comamonadaceae;Melaminivora;Melaminivora suipulveris	0	0	0	2	2
Bacteria;Bacteria_none;Bacteroidota;Cytophagia;Cytophagales;Fulvivirgaceae;Fulvivirga;Fulvivirga sp. SW1-E11	0	0	0	2	2
Bacteria;Bacteria_none;Bacillota;Clostridia;Eubacteriales;Vallitaleaceae;Vallitalea;Vallitalea pronyensis	2	0	0	0	2
Bacteria;Bacteria_none;Bacillota;Clostridia;Halanaerobiales;Halanaerobiaceae;Iocasia;Iocasia fonsfrigidae	0	0	0	2	2
Bacteria;Bacteria_none;Bacteroidota;Cytophagia;Cytophagales;Flammeovirgaceae;Flammeovirga;Flammeovirga kamogawensis	0	1	0	1	2
Bacteria;Bacteria_none;Bacillota;Clostridia;Thermoanaerobacterales;Thermoanaerobacterales Family III. Incertae Sedis;Thermoanaerobacterium;Thermoanaerobacterium xylanolyticum	0	0	2	0	2
Bacteria;Bacteria_none;Pseudomonadota;Gammaproteobacteria;Alteromonadales;Shewanellaceae;Shewanella;Shewanella sp. NFH-SH190041	0	0	0	2	2
Bacteria;Bacteria_none;Bacteroidota;Bacteroidia;Marinilabiliales;Prolixibacteraceae;Draconibacterium;Draconibacterium halophilum	0	0	0	2	2
Bacteria;Bacteria_none;Bacillota;Negativicutes;Veillonellales;Veillonellaceae;Veillonella;Veillonella parvula	1	1	0	0	2
Bacteria;Bacteria_none;Bacteroidota;Bacteroidia;Bacteroidales;Salinivirgaceae;Salinivirga;Salinivirga cyanobacteriivorans	0	0	0	2	2
Bacteria;Bacteria_none;Bacillota;Bacilli;Lactobacillales;Lactobacillaceae;Lactobacillus;Lactobacillus taiwanensis	0	1	1	0	2
Bacteria;Bacteria_none;Pseudomonadota;Epsilonproteobacteria;Campylobacterales;Arcobacteraceae;Aliarcobacter;Aliarcobacter butzleri	0	0	0	2	2
Bacteria;Bacteria_none;Bacillota;Bacilli;Bacillales;Paenibacillaceae;Paenibacillus;Paenibacillus sp. PHS-Z3	0	0	0	2	2
Bacteria;Bacteria_none;Actinomycetota;Actinomycetes;Kitasatosporales;Streptomycetaceae;Streptomyces;Streptomyces sp. 3211	0	0	2	0	2
Bacteria;Bacteria_none;Mycoplasmatota;Mollicutes;Mycoplasmatales;Mycoplasmataceae;Mycoplasma;Mycoplasma suis	0	1	0	1	2
Archaea;Archaea_none;Euryarchaeota;Halobacteria;Natrialbales;Natrialbaceae;Natribaculum;Natribaculum sp. CGA3	2	0	0	0	2
Eukaryota;Eukaryota_Incertae_sedis;Apicomplexa;Aconoidasida;Haemosporida;Plasmodiidae;Plasmodium;Plasmodium yoelii	0	0	1	1	2
Bacteria;Bacteria_none;Bacillota;Bacilli;Lactobacillales;Lactobacillaceae;Companilactobacillus;Companilactobacillus paralimentarius	2	0	0	0	2
Bacteria;Bacteria_none;Bacteroidota;Sphingobacteriia;Sphingobacteriales;Sphingobacteriaceae;Pedobacter;Pedobacter sp. PACM 27299	0	0	1	1	2
Eukaryota;Eukaryota_Incertae_sedis;Euglenozoa;Kinetoplastea;Trypanosomatida;Trypanosomatidae;Leishmania;Leishmania major	0	1	0	1	2
Bacteria;Bacteria_none;Bacillota;Bacilli;Bacillales;Bacillaceae;Pradoshia;Pradoshia sp. D12	0	2	0	0	2
Bacteria;Bacteria_none;Bacteroidota;Sphingobacteriia;Sphingobacteriales;Sphingobacteriaceae;Solitalea;Solitalea canadensis	0	0	0	2	2
Bacteria;Bacteria_none;Pseudomonadota;Alphaproteobacteria;Hyphomicrobiales;Phyllobacteriaceae;Mesorhizobium;Mesorhizobium sp. INR15	1	0	1	0	2
Eukaryota;Fungi;Ascomycota;Sordariomycetes;Hypocreales;Nectriaceae;Fusarium;Fusarium oxysporum	0	0	1	1	2
Bacteria;Bacteria_none;Pseudomonadota;Alphaproteobacteria;Hyphomicrobiales;Nitrobacteraceae;Bradyrhizobium;Bradyrhizobium sp. CCBAU 53421	0	0	0	2	2
Bacteria;Bacteria_none;Bacillota;Bacilli;Bacillales;Bacillaceae;Salipaludibacillus;Salipaludibacillus sp. LMS25	0	2	0	0	2
Bacteria;Bacteria_none;Bacillota;Bacilli;Lactobacillales;Lactobacillaceae;Lacticaseibacillus;Lacticaseibacillus paracasei	2	0	0	0	2
Bacteria;Bacteria_none;Pseudomonadota;Alphaproteobacteria;Hyphomicrobiales;Bartonellaceae;Bartonella;Bartonella schoenbuchensis	0	0	0	2	2
Eukaryota;Eukaryota_Incertae_sedis;Apicomplexa;Aconoidasida;Haemosporida;Plasmodiidae;Plasmodium;Plasmodium berghei	0	1	0	1	2
Bacteria;Bacteria_none;Bacillota;Bacilli;Bacillales;Bacillaceae;Virgibacillus;Virgibacillus sp. Bac332	0	0	2	0	2
Eukaryota;Fungi;Ascomycota;Sordariomycetes;Hypocreales;Clavicipitaceae;Ustilaginoidea;Ustilaginoidea virens	1	1	0	0	2
Bacteria;Bacteria_none;Bacillota;Bacilli;Bacillales;Staphylococcaceae;Staphylococcus;Staphylococcus sp. NRL 22/194	0	0	1	1	2
Bacteria;Bacteria_none;Bacillota;Bacilli;Bacillales;Bacillaceae;Bacillus;Bacillus cereus	0	0	0	2	2
Bacteria;Bacteria_none;Actinomycetota;Actinomycetes;Kitasatosporales;Streptomycetaceae;Streptomyces;Streptomyces sp. S063	0	1	0	1	2
Eukaryota;Eukaryota_Incertae_sedis;Apicomplexa;Aconoidasida;Haemosporida;Plasmodiidae;Plasmodium;Plasmodium reichenowi	0	2	0	0	2
Bacteria;Bacteria_none;Bacillota;Bacilli;Bacillales;Staphylococcaceae;Staphylococcus;Staphylococcus hominis	0	0	1	1	2
Bacteria;Bacteria_none;Bacillota;Bacilli;Bacillales;Staphylococcaceae;Staphylococcus;Staphylococcus arlettae	0	0	0	2	2
Eukaryota;Eukaryota_Incertae_sedis;Apicomplexa;Aconoidasida;Piroplasmida;Babesiidae;Babesia;Babesia microti	0	0	2	0	2
Eukaryota;Eukaryota_Incertae_sedis;Parabasalia;Parabasalia_Incertae_sedis;Trichomonadida;Trichomonadidae;Trichomonas;Trichomonas vaginalis	0	0	1	1	2
Eukaryota;Fungi;Ascomycota;Sordariomycetes;Magnaporthales;Pyriculariaceae;Pyricularia;Pyricularia pennisetigena	0	1	0	1	2
Eukaryota;Fungi;Basidiomycota;Pucciniomycetes;Pucciniales;Pucciniaceae;Puccinia;Puccinia triticina	1	0	0	1	2
Archaea;Archaea_none;Crenarchaeota;Thermoprotei;Thermofilales;Thermofilaceae;Thermofilum;Thermofilum adornatum	0	0	2	0	2
Bacteria;Bacteria_none;Fusobacteriota;Fusobacteriia;Fusobacteriales;Leptotrichiaceae;Leptotrichia;Leptotrichia sp. oral taxon 212	0	0	0	2	2
Bacteria;Bacteria_none;Mycoplasmatota;Mollicutes;Entomoplasmatales;Entomoplasmataceae;Mesoplasma;Mesoplasma florum	0	0	0	2	2
Bacteria;Bacteria_none;Bacteroidota;Flavobacteriia;Flavobacteriales;Weeksellaceae;Cloacibacterium;Cloacibacterium normanense	0	0	2	0	2
Eukaryota;Fungi;Ascomycota;Saccharomycetes;Saccharomycetales;Debaryomycetaceae;Debaryomyces;Debaryomyces hansenii	0	2	0	0	2
Bacteria;Bacteria_none;Bacteroidota;Flavobacteriia;Flavobacteriales;Weeksellaceae;Elizabethkingia;Elizabethkingia meningoseptica	0	0	0	2	2
Eukaryota;Fungi;Ascomycota;Eurotiomycetes;Eurotiales;Aspergillaceae;Aspergillus;Aspergillus nidulans	0	0	0	2	2
Bacteria;Bacteria_none;Actinomycetota;Actinomycetes;Streptosporangiales;Thermomonosporaceae;Actinomadura;Actinomadura sp. WMMB 499	0	1	0	1	2
Bacteria;Bacteria_none;Pseudomonadota;Alphaproteobacteria;Hyphomicrobiales;Stappiaceae;Labrenzia;Labrenzia sp. THAF82	0	0	0	2	2
Eukaryota;Fungi;Ascomycota;Saccharomycetes;Saccharomycetales;Phaffomycetaceae;Komagataella;Komagataella phaffii	0	0	1	1	2
Bacteria;Bacteria_none;Bacillota;Bacilli;Lactobacillales;Lactobacillaceae;Lactobacillus;Lactobacillus acetotolerans	0	2	0	0	2
Bacteria;Bacteria_none;Bacillota;Bacilli;Bacillales;Bacillaceae;Bacillus;Bacillus weihaiensis	0	0	0	2	2
Bacteria;Bacteria_none;Bacteroidota;Saprospiria;Saprospirales;Saprospiraceae;Saprospira;Saprospira grandis	0	1	0	1	2
Bacteria;Bacteria_none;Fusobacteriota;Fusobacteriia;Fusobacteriales;Fusobacteriaceae;Fusobacterium;Fusobacterium varium	0	0	0	2	2
Bacteria;Bacteria_none;Bacillota;Bacilli;Bacillales;Bacillaceae;Bacillus;Bacillus dafuensis	0	0	0	2	2
Bacteria;Bacteria_none;Actinomycetota;Coriobacteriia;Coriobacteriales;Coriobacteriaceae;Collinsella;Collinsella aerofaciens	0	0	0	2	2
Bacteria;Bacteria_none;Cyanobacteriota;Cyanophyceae;Nostocales;Nostocaceae;Nostoc;Nostoc sp. C057	0	0	0	2	2
Bacteria;Bacteria_none;Bacillota;Bacilli;Bacillales;Paenibacillaceae;Paenibacillus;Paenibacillus sp. 481	0	0	2	0	2
Bacteria;Bacteria_none;Bacillota;Bacilli;Bacillales;Paenibacillaceae;Cohnella;Cohnella abietis	0	0	0	2	2
Bacteria;Bacteria_none;Bacillota;Bacilli;Bacillales;Paenibacillaceae;Paenibacillus;Paenibacillus sp. 19GGS1-52	0	0	0	2	2
Eukaryota;Fungi;Ascomycota;Sordariomycetes;Glomerellales;Glomerellaceae;Colletotrichum;Colletotrichum lupini	1	0	0	1	2
Bacteria;Bacteria_none;Fusobacteriota;Fusobacteriia;Fusobacteriales;Fusobacteriaceae;Fusobacterium;Fusobacterium nucleatum	0	0	0	2	2
Bacteria;Bacteria_none;Pseudomonadota;Betaproteobacteria;Burkholderiales;Sphaerotilaceae;Roseateles;Roseateles depolymerans	0	0	0	1	1
Bacteria;Bacteria_none;Planctomycetota;Planctomycetia;Pirellulales;Lacipirellulaceae;Lacipirellula;Lacipirellula limnantheis	0	0	0	1	1
Bacteria;Bacteria_none;Pseudomonadota;Betaproteobacteria;Burkholderiales;Comamonadaceae;Diaphorobacter;Diaphorobacter sp. HDW4B	0	0	1	0	1
Bacteria;Bacteria_none;Pseudomonadota;Betaproteobacteria;Burkholderiales;Comamonadaceae;Kinneretia;Kinneretia sp. DAIF2	1	0	0	0	1
Bacteria;Bacteria_none;Planctomycetota;Planctomycetia;Isosphaerales;Isosphaeraceae;Aquisphaera;Aquisphaera giovannonii	0	1	0	0	1
Bacteria;Bacteria_none;Pseudomonadota;Betaproteobacteria;Neisseriales;Neisseriaceae;Neisseria;Neisseria elongata	1	0	0	0	1
Bacteria;Bacteria_none;Pseudomonadota;Betaproteobacteria;Neisseriales;Neisseriaceae;Neisseria;Neisseria bacilliformis	0	0	0	1	1
Bacteria;Bacteria_none;Pseudomonadota;Betaproteobacteria;Burkholderiales;Oxalobacteraceae;Janthinobacterium;Janthinobacterium svalbardensis	0	0	0	1	1
Bacteria;Bacteria_none;Planctomycetota;Planctomycetia;Pirellulales;Pirellulaceae;Mariniblastus;Mariniblastus fucicola	0	0	0	1	1
Bacteria;Bacteria_none;Planctomycetota;Planctomycetia;Pirellulales;Pirellulaceae;Bremerella;Bremerella volcania	0	0	1	0	1
Bacteria;Bacteria_none;Pseudomonadota;Betaproteobacteria;Burkholderiales;Comamonadaceae;Polaromonas;Polaromonas naphthalenivorans	0	0	1	0	1
Bacteria;Bacteria_none;Pseudomonadota;Betaproteobacteria;Neisseriales;Neisseriaceae;Kingella;Kingella potus	0	0	0	1	1
Bacteria;Bacteria_none;Pseudomonadota;Betaproteobacteria;Burkholderiales;Oxalobacteraceae;Pseudoduganella;Pseudoduganella plicata	0	0	0	1	1
Bacteria;Bacteria_none;Pseudomonadota;Betaproteobacteria;Neisseriales;Chromobacteriaceae;Chromobacterium;Chromobacterium vaccinii	0	0	0	1	1
Bacteria;Bacteria_none;Pseudomonadota;Betaproteobacteria;Neisseriales;Chromobacteriaceae;Chromobacterium;Chromobacterium sp. Rain0013	0	0	0	1	1
Bacteria;Bacteria_none;Pseudomonadota;Betaproteobacteria;Burkholderiales;Oxalobacteraceae;Pseudoduganella;Pseudoduganella flava	0	1	0	0	1
Bacteria;Bacteria_none;Pseudomonadota;Betaproteobacteria;Burkholderiales;Oxalobacteraceae;Massilia;Massilia sp. NP310	0	0	1	0	1
Bacteria;Bacteria_none;Pseudomonadota;Deltaproteobacteria;Desulfobacterales;Desulfobulbaceae;Desulfobulbus;Desulfobulbus propionicus	0	0	0	1	1
Bacteria;Bacteria_none;Actinomycetota;Actinomycetes;Kitasatosporales;Streptomycetaceae;Streptomyces;Streptomyces davaonensis	0	1	0	0	1
Bacteria;Bacteria_none;Pseudomonadota;Betaproteobacteria;Neisseriales;Neisseriaceae;Neisseria;Neisseria weixii	0	0	0	1	1
Bacteria;Bacteria_none;Ignavibacteriae;Ignavibacteria;Ignavibacteriales;Ignavibacteriaceae;Ignavibacterium;Ignavibacterium album	0	0	0	1	1
Bacteria;Bacteria_none;Pseudomonadota;Deltaproteobacteria;Myxococcales;Nannocystaceae;Nannocystis;Nannocystis sp. fl3	0	0	0	1	1
Bacteria;Bacteria_none;Mycoplasmatota;Mollicutes;Entomoplasmatales;Spiroplasmataceae;Spiroplasma;Spiroplasma clarkii	0	0	0	1	1
Bacteria;Bacteria_none;Pseudomonadota;Deltaproteobacteria;Myxococcales;Archangiaceae;Archangium;Archangium violaceum	0	0	1	0	1
Bacteria;Bacteria_none;Pseudomonadota;Deltaproteobacteria;Desulfuromonadales;Geobacteraceae;Geobacter;Geobacter benzoatilyticus	0	0	0	1	1
Bacteria;Bacteria_none;Pseudomonadota;Deltaproteobacteria;Desulfuromonadales;Geobacteraceae;Geoalkalibacter;Geoalkalibacter subterraneus	1	0	0	0	1
Bacteria;Bacteria_none;Mycoplasmatota;Mollicutes;Entomoplasmatales;Spiroplasmataceae;Spiroplasma;Spiroplasma endosymbiont of 'Nebria riversi'	0	0	0	1	1
Bacteria;Bacteria_none;Mycoplasmatota;Mollicutes;Entomoplasmatales;Spiroplasmataceae;Spiroplasma;Spiroplasma sp. TIUS-1	0	1	0	0	1
Bacteria;Bacteria_none;Actinomycetota;Actinomycetes;Kitasatosporales;Streptomycetaceae;Kitasatospora;Kitasatospora sp. NA04385	0	1	0	0	1
Bacteria;Bacteria_none;Mycoplasmatota;Mollicutes;Mycoplasmatales;Mycoplasmataceae;Mycoplasma;Mycoplasma capricolum	0	1	0	0	1
Bacteria;Bacteria_none;Pseudomonadota;Deltaproteobacteria;Desulfovibrionales;Desulfovibrionaceae;Pseudodesulfovibrio;Pseudodesulfovibrio cashew	0	0	0	1	1
Bacteria;Bacteria_none;Mycoplasmatota;Mollicutes;Mycoplasmatales;Mycoplasmataceae;Mycoplasma;Mycoplasma mycoides	0	0	1	0	1
Bacteria;Bacteria_none;Actinomycetota;Actinomycetes;Kitasatosporales;Streptomycetaceae;Streptomyces;Streptomyces capitiformicae	0	1	0	0	1
Bacteria;Bacteria_none;Pseudomonadota;Deltaproteobacteria;Desulfovibrionales;Desulfovibrionaceae;Desulfovibrio;Desulfovibrio fairfieldensis	0	1	0	0	1
Bacteria;Bacteria_none;Mycoplasmatota;Mollicutes;Mycoplasmatales;Mycoplasmataceae;Mycoplasmopsis;Mycoplasmopsis bovis	0	1	0	0	1
Bacteria;Bacteria_none;Mycoplasmatota;Mollicutes;Mycoplasmatales;Mycoplasmataceae;Mycoplasmopsis;Mycoplasmopsis cynos	0	1	0	0	1
Bacteria;Bacteria_none;Mycoplasmatota;Mollicutes;Mycoplasmatales;Mycoplasmataceae;Mycoplasmopsis;Mycoplasmopsis maculosa	0	0	0	1	1
Bacteria;Bacteria_none;Actinomycetota;Actinomycetes;Kitasatosporales;Streptomycetaceae;Streptomyces;Streptomyces niveus	0	1	0	0	1
Bacteria;Bacteria_none;Actinomycetota;Actinomycetes;Kitasatosporales;Streptomycetaceae;Streptomyces;Streptomyces lydicus	0	1	0	0	1
Bacteria;Bacteria_none;Pseudomonadota;Deltaproteobacteria;Desulfobacterales;Desulfocapsaceae;Desulfotalea;Desulfotalea psychrophila	1	0	0	0	1
Bacteria;Bacteria_none;Pseudomonadota;Betaproteobacteria;Burkholderiales;Comamonadaceae;Acidovorax;Acidovorax sp. JMULE5	1	0	0	0	1
Bacteria;Bacteria_none;Pseudomonadota;Deltaproteobacteria;Desulfobacterales;Desulfobulbaceae;Desulfobulbus;Desulfobulbus oralis	0	0	0	1	1
Bacteria;Bacteria_none;Pseudomonadota;Deltaproteobacteria;Desulfobacterales;Desulfobacteraceae;Desulfonema;Desulfonema limicola	0	0	0	1	1
Bacteria;Bacteria_none;Actinomycetota;Actinomycetes;Kitasatosporales;Streptomycetaceae;Streptomyces;Streptomyces lincolnensis	0	0	1	0	1
Bacteria;Bacteria_none;Pseudomonadota;Deltaproteobacteria;Desulfobacterales;Desulfobacteraceae;Desulfatibacillum;Desulfatibacillum aliphaticivorans	0	0	0	1	1
Bacteria;Bacteria_none;Planctomycetota;Planctomycetia;Gemmatales;Gemmataceae;Gemmata;Gemmata obscuriglobus	0	0	1	0	1
Bacteria;Bacteria_none;Pseudomonadota;Betaproteobacteria;Rhodocyclales;Azonexaceae;Quatrionicoccus;Quatrionicoccus australiensis	0	0	0	1	1
Bacteria;Bacteria_none;Pseudomonadota;Betaproteobacteria;Nitrosomonadales;Sterolibacteriaceae;Sulfuritalea;Sulfuritalea hydrogenivorans	0	1	0	0	1
Bacteria;Bacteria_none;Actinomycetota;Actinomycetes;Kitasatosporales;Streptomycetaceae;Streptomyces;Streptomyces cyaneochromogenes	0	1	0	0	1
Bacteria;Bacteria_none;Pseudomonadota;Betaproteobacteria;Burkholderiales;Comamonadaceae;Diaphorobacter;Diaphorobacter sp. HDW4A	0	0	1	0	1
Bacteria;Bacteria_none;Pseudomonadota;Alphaproteobacteria;Rhodobacterales;Paracoccaceae;Paracoccus;Paracoccus sanguinis	0	0	1	0	1
Bacteria;Bacteria_none;Pseudomonadota;Betaproteobacteria;Burkholderiales;Burkholderiaceae;Polynucleobacter;Polynucleobacter sp. MWH-UH25E	0	0	0	1	1
Bacteria;Bacteria_none;Pseudomonadota;Alphaproteobacteria;Hyphomicrobiales;Methylocystaceae;Methylocystis;Methylocystis sp. SC2	0	0	0	1	1
Bacteria;Bacteria_none;Pseudomonadota;Alphaproteobacteria;Hyphomicrobiales;Rhizobiaceae;Neorhizobium;Neorhizobium galegae	0	1	0	0	1
Bacteria;Bacteria_none;Pseudomonadota;Alphaproteobacteria;Hyphomicrobiales;Rhizobiaceae;Liberibacter;Candidatus Liberibacter solanacearum	0	1	0	0	1
Bacteria;Bacteria_none;Pseudomonadota;Alphaproteobacteria;Sphingomonadales;Erythrobacteraceae;Tsuneonella;Tsuneonella flava	0	1	0	0	1
Bacteria;Bacteria_none;Pseudomonadota;Alphaproteobacteria;Hyphomicrobiales;Rhizobiaceae;Agrobacterium;Agrobacterium vitis	0	0	0	1	1
Bacteria;Bacteria_none;Pseudomonadota;Epsilonproteobacteria;Campylobacterales;Arcobacteraceae;Arcobacter;Arcobacter acticola	0	0	0	1	1
Bacteria;Bacteria_none;Pseudomonadota;Alphaproteobacteria;Sphingomonadales;Sphingomonadaceae;Blastomonas;Blastomonas sp. RAC04	0	1	0	0	1
Bacteria;Bacteria_none;Pseudomonadota;Alphaproteobacteria;Sphingomonadales;Sphingomonadaceae;Sphingomonas;Sphingomonas aliaeris	0	1	0	0	1
Bacteria;Bacteria_none;Pseudomonadota;Alphaproteobacteria;Sphingomonadales;Sphingomonadaceae;Sphingomonas;Sphingomonas melonis	0	0	1	0	1
Bacteria;Bacteria_none;Pseudomonadota;Alphaproteobacteria;Hyphomicrobiales;Phyllobacteriaceae;Mesorhizobium;Mesorhizobium sp. NZP2298	0	0	0	1	1
Bacteria;Bacteria_none;Pseudomonadota;Alphaproteobacteria;Hyphomicrobiales;Phyllobacteriaceae;Mesorhizobium;Mesorhizobium sp. M3A.F.Ca.ET.080.04.2.1	0	1	0	0	1
Bacteria;Bacteria_none;Pseudomonadota;Alphaproteobacteria;Sphingomonadales;Sphingomonadaceae;Sphingomonas;Sphingomonas morindae	1	0	0	0	1
Bacteria;Bacteria_none;Pseudomonadota;Alphaproteobacteria;Sphingomonadales;Sphingomonadaceae;Sphingomonas;Sphingomonas sp. HMP6	0	0	0	1	1
Bacteria;Bacteria_none;Pseudomonadota;Alphaproteobacteria;Sphingomonadales;Sphingomonadaceae;Sphingomonas;Sphingomonas sp. HMP9	0	0	0	1	1
Bacteria;Bacteria_none;Pseudomonadota;Alphaproteobacteria;Hyphomicrobiales;Phreatobacteraceae;Phreatobacter;Phreatobacter sp. NMCR1094	1	0	0	0	1
Bacteria;Bacteria_none;Pseudomonadota;Alphaproteobacteria;Hyphomicrobiales;Nitrobacteraceae;Tardiphaga;Tardiphaga sp. vice154	0	0	1	0	1
Bacteria;Bacteria_none;Pseudomonadota;Alphaproteobacteria;Rickettsiales;Rickettsiales_Incertae_sedis;Rickettsiales_Incertae_sedis_Incertae_sedis;Rickettsiales endosymbiont of Stachyamoeba lipophora	0	0	0	1	1
Bacteria;Bacteria_none;Pseudomonadota;Alphaproteobacteria;Rickettsiales;Candidatus Midichloriaceae;Candidatus Midichloria;Candidatus Midichloria mitochondrii	0	0	0	1	1
Bacteria;Bacteria_none;Pseudomonadota;Alphaproteobacteria;Hyphomicrobiales;Rhizobiaceae;Rhizobium;Rhizobium leguminosarum	0	0	0	1	1
Bacteria;Bacteria_none;Pseudomonadota;Alphaproteobacteria;Rhodobacterales;Roseobacteraceae;Octadecabacter;Octadecabacter sp. SW4	0	0	0	1	1
Bacteria;Bacteria_none;Actinomycetota;Actinomycetes;Kitasatosporales;Streptomycetaceae;Streptomyces;Streptomyces glaucescens	0	0	1	0	1
Bacteria;Bacteria_none;Pseudomonadota;Alphaproteobacteria;Hyphomonadales;Hyphomonadaceae;Hyphomonas;Hyphomonas sp. CACIAM 19H1	0	0	0	1	1
Bacteria;Bacteria_none;Pseudomonadota;Alphaproteobacteria;Hyphomonadales;Hyphomonadaceae;Hyphomonas;Hyphomonas atlantica	0	0	0	1	1
Bacteria;Bacteria_none;Pseudomonadota;Alphaproteobacteria;Hyphomonadales;Hyphomonadaceae;Candidatus Viadribacter;Candidatus Viadribacter manganicus	0	1	0	0	1
Bacteria;Bacteria_none;Pseudomonadota;Alphaproteobacteria;Hyphomicrobiales;Stappiaceae;Roseibium;Roseibium aggregatum	1	0	0	0	1
Bacteria;Bacteria_none;Pseudomonadota;Alphaproteobacteria;Rhodobacterales;Roseobacteraceae;Leisingera;Leisingera sp. M523	0	0	0	1	1
Bacteria;Bacteria_none;Pseudomonadota;Alphaproteobacteria;Hyphomicrobiales;Rhizobiaceae;Rhizobium;Rhizobium sp. Pop5	0	0	0	1	1
Bacteria;Bacteria_none;Pseudomonadota;Alphaproteobacteria;Rickettsiales;Anaplasmataceae;Ehrlichia;Ehrlichia canis	0	0	0	1	1
Bacteria;Bacteria_none;Pseudomonadota;Alphaproteobacteria;Hyphomicrobiales;Rhizobiaceae;Rhizobium;Rhizobium sp. ACO-34A	0	0	1	0	1
Bacteria;Bacteria_none;Pseudomonadota;Alphaproteobacteria;Rhodobacterales;Roseobacteraceae;Salipiger;Salipiger abyssi	0	1	0	0	1
Bacteria;Bacteria_none;Pseudomonadota;Alphaproteobacteria;Rhodobacterales;Roseobacteraceae;Thalassobacter;Thalassobacter stenotrophicus	0	0	0	1	1
Bacteria;Bacteria_none;Pseudomonadota;Alphaproteobacteria;Hyphomicrobiales;Rhizobiaceae;Rhizobium;Rhizobium pseudoryzae	0	0	0	1	1
Bacteria;Bacteria_none;Pseudomonadota;Alphaproteobacteria;Rhodobacterales;Roseobacteraceae;Yangia;Yangia pacifica	0	0	1	0	1
Bacteria;Bacteria_none;Pseudomonadota;Alphaproteobacteria;Rhodospirillales;Geminicoccaceae;Tistrella;Tistrella mobilis	0	0	1	0	1
Bacteria;Bacteria_none;Actinomycetota;Actinomycetes;Kitasatosporales;Streptomycetaceae;Streptomyces;Streptomyces incarnatus	0	0	0	1	1
Bacteria;Bacteria_none;Pseudomonadota;Alphaproteobacteria;Hyphomicrobiales;Methylobacteriaceae;Methylorubrum;Methylorubrum sp. B1-46	0	1	0	0	1
Bacteria;Bacteria_none;Pseudomonadota;Betaproteobacteria;Burkholderiales;Burkholderiaceae;Polynucleobacter;Polynucleobacter sp. AP-Elch-400A-B2	0	0	0	1	1
Bacteria;Bacteria_none;Pseudomonadota;Alphaproteobacteria;Sphingomonadales;Sphingomonadaceae;Sphingopyxis;Sphingopyxis sp. YF1	0	1	0	0	1
Bacteria;Bacteria_none;Pseudomonadota;Alphaproteobacteria;Hyphomicrobiales;Bartonellaceae;Bartonella;Bartonella clarridgeiae	0	1	0	0	1
Bacteria;Bacteria_none;Pseudomonadota;Alphaproteobacteria;Hyphomicrobiales;Aurantimonadaceae;Aureimonas;Aureimonas populi	0	0	1	0	1
Bacteria;Bacteria_none;Pseudomonadota;Alphaproteobacteria;Emcibacterales;Emcibacteraceae;Pseudemcibacter;Pseudemcibacter aquimaris	0	1	0	0	1
Bacteria;Bacteria_none;Pseudomonadota;Betaproteobacteria;Burkholderiales;Burkholderiaceae;Limnobacter;Limnobacter sp. SAORIC-580	1	0	0	0	1
Bacteria;Bacteria_none;Pseudomonadota;Betaproteobacteria;Burkholderiales;Burkholderiaceae;Paraburkholderia;Paraburkholderia caledonica	0	0	1	0	1
Bacteria;Bacteria_none;Pseudomonadota;Betaproteobacteria;Burkholderiales;Burkholderiaceae;Paraburkholderia;Paraburkholderia caribensis	0	0	0	1	1
Bacteria;Bacteria_none;Pseudomonadota;Alphaproteobacteria;Emcibacterales;Emcibacteraceae;Luteithermobacter;Luteithermobacter gelatinilyticus	1	0	0	0	1
Bacteria;Bacteria_none;Pseudomonadota;Alphaproteobacteria;Rhodobacterales;Paracoccaceae;Paracoccus;Paracoccus contaminans	0	1	0	0	1
Bacteria;Bacteria_none;Actinomycetota;Actinomycetes;Kitasatosporales;Streptomycetaceae;Streptomyces;Streptomyces genisteinicus	1	0	0	0	1
Bacteria;Bacteria_none;Pseudomonadota;Alphaproteobacteria;Caulobacterales;Caulobacteraceae;Brevundimonas;Brevundimonas subvibrioides	0	1	0	0	1
Bacteria;Bacteria_none;Planctomycetota;Planctomycetia;Planctomycetales;Planctomycetaceae;Gimesia;Gimesia chilikensis	1	0	0	0	1
Bacteria;Bacteria_none;Pseudomonadota;Betaproteobacteria;Burkholderiales;Burkholderiaceae;Paraburkholderia;Paraburkholderia xenovorans	0	0	1	0	1
Bacteria;Bacteria_none;Planctomycetota;Planctomycetia;Planctomycetales;Planctomycetaceae;Crateriforma;Crateriforma conspicua	1	0	0	0	1
Bacteria;Bacteria_none;Pseudomonadota;Betaproteobacteria;Burkholderiales;Burkholderiaceae;Polynucleobacter;Polynucleobacter corsicus	0	0	0	1	1
Bacteria;Bacteria_none;Planctomycetota;Planctomycetia;Pirellulales;Thermoguttaceae;Thermogutta;Thermogutta terrifontis	0	0	1	0	1
Bacteria;Bacteria_none;Pseudomonadota;Betaproteobacteria;Burkholderiales;Burkholderiaceae;Cupriavidus;Cupriavidus necator	0	0	0	1	1
Bacteria;Bacteria_none;Pseudomonadota;Betaproteobacteria;Burkholderiales;Burkholderiaceae;Cupriavidus;Cupriavidus metallidurans	0	1	0	0	1
Bacteria;Bacteria_none;Pseudomonadota;Alphaproteobacteria;Hyphomicrobiales;Bartonellaceae;Bartonella;Bartonella vinsonii	0	0	1	0	1
Bacteria;Bacteria_none;Pseudomonadota;Betaproteobacteria;Burkholderiales;Alcaligenaceae;Bordetella;Bordetella sp. N	0	1	0	0	1
Bacteria;Bacteria_none;Pseudomonadota;Betaproteobacteria;Burkholderiales;Alcaligenaceae;Achromobacter;Achromobacter spanius	0	0	0	1	1
Bacteria;Bacteria_none;Pseudomonadota;Alphaproteobacteria;Hyphomicrobiales;Methylobacteriaceae;Methylorubrum;Methylorubrum populi	0	0	0	1	1
Bacteria;Bacteria_none;Actinomycetota;Actinomycetes;Kitasatosporales;Streptomycetaceae;Streptomyces;Streptomyces leeuwenhoekii	0	1	0	0	1
Bacteria;Bacteria_none;Pseudomonadota;Alphaproteobacteria;Hyphomicrobiales;Lichenihabitantaceae;Lichenihabitans;Lichenihabitans sp. PAMC28606	0	0	1	0	1
Bacteria;Bacteria_none;Pseudomonadota;Betaproteobacteria;Burkholderiales;Alcaligenaceae;Bordetella;Bordetella bronchiseptica	0	0	1	0	1
Bacteria;Bacteria_none;Pseudomonadota;Alphaproteobacteria;Hyphomicrobiales;Kaistiaceae;Kaistia;Kaistia sp. 32K	0	1	0	0	1
Bacteria;Bacteria_none;Pseudomonadota;Betaproteobacteria;Burkholderiales;Alcaligenaceae;Pusillimonas;Pusillimonas sp. DMV24BSW_D	0	1	0	0	1
Bacteria;Bacteria_none;Pseudomonadota;Betaproteobacteria;Burkholderiales;Burkholderiaceae;Cupriavidus;Cupriavidus basilensis	0	1	0	0	1
Bacteria;Bacteria_none;Pseudomonadota;Alphaproteobacteria;Hyphomicrobiales;Hyphomicrobiaceae;Rhodoplanes;Rhodoplanes piscinae	1	0	0	0	1
Bacteria;Bacteria_none;Pseudomonadota;Betaproteobacteria;Burkholderiales;Burkholderiaceae;Burkholderia;Burkholderia gladioli	1	0	0	0	1
Bacteria;Bacteria_none;Pseudomonadota;Alphaproteobacteria;Hyphomicrobiales;Chelatococcaceae;Chelatococcus;Chelatococcus sp. CO-6	0	0	1	0	1
Bacteria;Bacteria_none;Pseudomonadota;Alphaproteobacteria;Hyphomicrobiales;Boseaceae;Bosea;Bosea sp. Tri-49	0	0	0	1	1
Bacteria;Bacteria_none;Pseudomonadota;Alphaproteobacteria;Hyphomicrobiales;Blastochloridaceae;Blastochloris;Blastochloris tepida	0	0	0	1	1
Bacteria;Bacteria_none;Pseudomonadota;Betaproteobacteria;Burkholderiales;Burkholderiaceae;Burkholderia;Burkholderia sp. PAMC 26561	0	1	0	0	1
Bacteria;Bacteria_none;Bacillota;Bacilli;Bacillales;Bacillaceae;Bacillus;Bacillus pumilus	0	0	0	1	1
Bacteria;Bacteria_none;Pseudomonadota;Gammaproteobacteria;Alteromonadales;Shewanellaceae;Shewanella;Shewanella glacialimarina	0	0	0	1	1
Bacteria;Bacteria_none;Pseudomonadota;Epsilonproteobacteria;Campylobacterales;Arcobacteraceae;Halarcobacter;Halarcobacter bivalviorum	0	0	1	0	1
Bacteria;Bacteria_none;Spirochaetota;Spirochaetia;Leptospirales;Leptospiraceae;Leptospira;Leptospira sp. GIMC2001	0	0	1	0	1
Bacteria;Bacteria_none;Pseudomonadota;Gammaproteobacteria;Xanthomonadales;Xanthomonadaceae;Xanthomonas;Xanthomonas hydrangeae	0	0	0	1	1
Bacteria;Bacteria_none;Pseudomonadota;Gammaproteobacteria;Xanthomonadales;Xanthomonadaceae;Xanthomonas;Xanthomonas oryzae	1	0	0	0	1
Bacteria;Bacteria_none;Pseudomonadota;Gammaproteobacteria;Xanthomonadales;Xanthomonadaceae;Xanthomonas;Xanthomonas sacchari	0	0	0	1	1
Bacteria;Bacteria_none;Pseudomonadota;Gammaproteobacteria;Xanthomonadales;Xanthomonadaceae;Xanthomonas;Xanthomonas theicola	0	0	0	1	1
Bacteria;Bacteria_none;Pseudomonadota;Oligoflexia;Bacteriovoracales;Halobacteriovoraceae;Halobacteriovorax;Halobacteriovorax sp. BALOs_7	0	0	0	1	1
Bacteria;Bacteria_none;Spirochaetota;Spirochaetia;Brachyspirales;Brachyspiraceae;Brachyspira;Brachyspira hampsonii	1	0	0	0	1
Bacteria;Bacteria_none;Spirochaetota;Spirochaetia;Brachyspirales;Brachyspiraceae;Brachyspira;Brachyspira murdochii	1	0	0	0	1
Archaea;Archaea_none;Thaumarchaeota;Nitrososphaeria;Nitrososphaerales;Nitrososphaeraceae;Nitrososphaera;Candidatus Nitrososphaera evergladensis	0	0	0	1	1
Bacteria;Bacteria_none;Spirochaetota;Spirochaetia;Leptospirales;Leptospiraceae;Leptospira;Leptospira tipperaryensis	0	1	0	0	1
Bacteria;Bacteria_none;Pseudomonadota;Gammaproteobacteria;Xanthomonadales;Xanthomonadaceae;Xanthomonas;Xanthomonas campestris	0	0	1	0	1
Bacteria;Bacteria_none;Spirochaetota;Spirochaetia;Spirochaetales;Borreliaceae;Borreliella;Candidatus Borreliella tachyglossi	0	0	0	1	1
Bacteria;Bacteria_none;Spirochaetota;Spirochaetia;Spirochaetales;Treponemataceae;Treponema;Treponema denticola	0	0	0	1	1
Bacteria;Bacteria_none;Spirochaetota;Spirochaetia;Spirochaetales;Treponemataceae;Treponema;Treponema peruense	0	0	1	0	1
Bacteria;Bacteria_none;Spirochaetota;Spirochaetia;Spirochaetales;Treponemataceae;Treponema;Treponema phagedenis	0	0	0	1	1
Bacteria;Bacteria_none;Spirochaetota;Spirochaetia;Spirochaetales;Treponemataceae;Treponema;Treponema vincentii	0	0	0	1	1
Archaea;Archaea_none;Euryarchaeota;Thermococci;Thermococcales;Thermococcaceae;Thermococcus;Thermococcus guaymasensis	0	1	0	0	1
Bacteria;Bacteria_none;Thermodesulfobacteria;Thermodesulfobacteria;Thermodesulfobacteriales;Thermodesulfobacteriaceae;Caldimicrobium;Caldimicrobium thiodismutans	0	1	0	0	1
Bacteria;Bacteria_none;Thermotogota;Thermotogae;Kosmotogales;Kosmotogaceae;Kosmotoga;Kosmotoga olearia	0	0	0	1	1
Bacteria;Bacteria_none;Pseudomonadota;Gammaproteobacteria;Xanthomonadales;Xanthomonadaceae;Xanthomonas;Xanthomonas cassavae	0	0	1	0	1
Bacteria;Bacteria_none;Pseudomonadota;Gammaproteobacteria;Xanthomonadales;Xanthomonadaceae;Stenotrophomonas;Stenotrophomonas rhizophila	1	0	0	0	1
Eukaryota;Eukaryota_Incertae_sedis;Apicomplexa;Aconoidasida;Haemosporida;Plasmodiidae;Plasmodium;Plasmodium chabaudi	0	0	0	1	1
Bacteria;Bacteria_none;Pseudomonadota;Gammaproteobacteria;Thiotrichales;Piscirickettsiaceae;Thiomicrorhabdus;Thiomicrorhabdus xiamenensis	0	0	0	1	1
Bacteria;Bacteria_none;Pseudomonadota;Gammaproteobacteria;Pseudomonadales;Pseudomonadaceae;Pseudomonas;Pseudomonas seleniipraecipitans	0	0	0	1	1
Bacteria;Bacteria_none;Pseudomonadota;Gammaproteobacteria;Pseudomonadales;Pseudomonadaceae;Pseudomonas;Pseudomonas sp. Cab53	1	0	0	0	1
Bacteria;Bacteria_none;Pseudomonadota;Gammaproteobacteria;Pseudomonadales;Pseudomonadaceae;Pseudomonas;Pseudomonas sp. DR 5-09	0	0	1	0	1
Bacteria;Bacteria_none;Pseudomonadota;Gammaproteobacteria;Pseudomonadales;Pseudomonadaceae;Pseudomonas;Pseudomonas sp. IT P374	0	0	0	1	1
Bacteria;Bacteria_none;Pseudomonadota;Gammaproteobacteria;Pseudomonadales;Pseudomonadaceae;Pseudomonas;Pseudomonas sp. LS44	0	0	0	1	1
Bacteria;Bacteria_none;Pseudomonadota;Gammaproteobacteria;Pseudomonadales;Pseudomonadaceae;Pseudomonas;Pseudomonas sp. Marseille-Q3773	0	0	0	1	1
Bacteria;Bacteria_none;Pseudomonadota;Gammaproteobacteria;Pseudomonadales;Pseudomonadaceae;Pseudomonas;Pseudomonas sp. URMO17WK12:I11	0	0	1	0	1
Bacteria;Bacteria_none;Pseudomonadota;Gammaproteobacteria;Pseudomonadales;Pseudomonadaceae;Pseudomonas;Pseudomonas vanderleydeniana	0	0	0	1	1
Bacteria;Bacteria_none;Pseudomonadota;Gammaproteobacteria;Thiotrichales;Piscirickettsiaceae;Thiosulfatimonas;Thiosulfatimonas sediminis	0	0	0	1	1
Archaea;Archaea_none;Thaumarchaeota;Nitrososphaeria;Nitrososphaerales;Nitrososphaeraceae;Nitrososphaera;Candidatus Nitrososphaera gargensis	0	0	0	1	1
Bacteria;Bacteria_none;Pseudomonadota;Gammaproteobacteria;Vibrionales;Vibrionaceae;Aliivibrio;Aliivibrio fischeri	0	0	0	1	1
Bacteria;Bacteria_none;Pseudomonadota;Gammaproteobacteria;Vibrionales;Vibrionaceae;Photobacterium;Photobacterium swingsii	0	0	0	1	1
Bacteria;Bacteria_none;Pseudomonadota;Gammaproteobacteria;Vibrionales;Vibrionaceae;Vibrio;Vibrio ishigakensis	0	0	1	0	1
Bacteria;Bacteria_none;Pseudomonadota;Gammaproteobacteria;Vibrionales;Vibrionaceae;Vibrio;Vibrio mangrovi	0	0	0	1	1
Bacteria;Bacteria_none;Pseudomonadota;Gammaproteobacteria;Vibrionales;Vibrionaceae;Vibrio;Vibrio tubiashii	0	0	0	1	1
Bacteria;Bacteria_none;Pseudomonadota;Gammaproteobacteria;Xanthomonadales;Rhodanobacteraceae;Luteibacter;Luteibacter anthropi	0	0	0	1	1
Bacteria;Bacteria_none;Pseudomonadota;Gammaproteobacteria;Xanthomonadales;Xanthomonadaceae;Luteimonas;Luteimonas sp. YGD11-2	0	0	1	0	1
Bacteria;Bacteria_none;Pseudomonadota;Gammaproteobacteria;Xanthomonadales;Xanthomonadaceae;Pseudoxanthomonas;Pseudoxanthomonas mexicana	0	1	0	0	1
Bacteria;Bacteria_none;Verrucomicrobiota;Verrucomicrobiae;Verrucomicrobiales;Akkermansiaceae;Akkermansia;Akkermansia muciniphila	0	0	1	0	1
Eukaryota;Eukaryota_Incertae_sedis;Apicomplexa;Aconoidasida;Haemosporida;Plasmodiidae;Plasmodium;Plasmodium cynomolgi	0	0	0	1	1
Bacteria;Bacteria_none;Actinomycetota;Acidimicrobiia;Acidimicrobiales;Iamiaceae;Iamia;Iamia majanohamensis	0	0	1	0	1
Archaea;Archaea_none;Euryarchaeota;Halobacteria;Halobacteriales;Haloarculaceae;Halosimplex;Halosimplex sp. XZYJT29	0	0	1	0	1
Archaea;Archaea_none;Euryarchaeota;Methanomicrobia;Methanomicrobiales;Methanospirillaceae;Methanospirillum;Methanospirillum sp. J.3.6.1-F.2.7.3	1	0	0	0	1
Archaea;Archaea_none;Euryarchaeota;Methanobacteria;Methanobacteriales;Methanobacteriaceae;Methanosphaera;Methanosphaera stadtmanae	0	0	0	1	1
Archaea;Archaea_none;Euryarchaeota;Methanobacteria;Methanobacteriales;Methanobacteriaceae;Methanobacterium;Methanobacterium formicicum	0	0	0	1	1
Eukaryota;Fungi;Ascomycota;Sordariomycetes;Hypocreales;Nectriaceae;Fusarium;Fusarium venenatum	0	0	0	1	1
Eukaryota;Fungi;Ascomycota;Sordariomycetes;Hypocreales;Ophiocordycipitaceae;Purpureocillium;Purpureocillium takamizusanense	1	0	0	0	1
Eukaryota;Fungi;Ascomycota;Sordariomycetes;Magnaporthales;Pyriculariaceae;Pyricularia;Pyricularia grisea	0	0	1	0	1
Eukaryota;Fungi;Ascomycota;Sordariomycetes;Magnaporthales;Pyriculariaceae;Pyricularia;Pyricularia oryzae	0	0	0	1	1
Archaea;Archaea_none;Euryarchaeota;Halobacteria;Natrialbales;Natrialbaceae;Halovivax;Halovivax ruber	0	0	0	1	1
Eukaryota;Fungi;Basidiomycota;Tremellomycetes;Tremellales;Cryptococcaceae;Cryptococcus;Cryptococcus neoformans	0	0	0	1	1
Eukaryota;Fungi;Ascomycota;Sordariomycetes;Glomerellales;Glomerellaceae;Colletotrichum;Colletotrichum higginsianum	0	1	0	0	1
Archaea;Archaea_none;Euryarchaeota;Halobacteria;Halobacteriales;Haloarculaceae;Halorhabdus;Halorhabdus utahensis	0	0	0	1	1
Archaea;Archaea_none;Crenarchaeota;Thermoprotei;Thermoproteales;Thermoproteaceae;Pyrobaculum;Pyrobaculum aerophilum	1	0	0	0	1
Viruses;Heunggongvirae;Uroviricota;Caudoviricetes;Caudoviricetes_Incertae_sedis;Caudoviricetes_Incertae_sedis_Incertae_sedis;Sextaecvirus;Sextaecvirus sextaec	1	0	0	0	1
Viruses;Heunggongvirae;Uroviricota;Caudoviricetes;Caudoviricetes_Incertae_sedis;Helgolandviridae;Leefvirus;Leefvirus Leef	0	0	1	0	1
Viruses;Heunggongvirae;Uroviricota;Caudoviricetes;Caudoviricetes_Incertae_sedis;Kyanoviridae;Bristolvirus;Bristolvirus rhodeisland	0	0	0	1	1
Viruses;Heunggongvirae;Uroviricota;Caudoviricetes;Crassvirales;Crevaviridae;Kingevirus;Kingevirus communis	0	0	1	0	1
Viruses;Orthornavirae;Negarnaviricota;Insthoviricetes;Articulavirales;Orthomyxoviridae;Alphainfluenzavirus;Influenza A virus	0	0	1	0	1
Archaea;Archaea_none;Crenarchaeota;Thermoprotei;Sulfolobales;Sulfolobaceae;Sulfurisphaera;Sulfurisphaera ohwakuensis	0	0	0	1	1
Eukaryota;Fungi;Ascomycota;Sordariomycetes;Hypocreales;Clavicipitaceae;Pochonia;Pochonia chlamydosporia	0	0	1	0	1
Eukaryota;Fungi;Ascomycota;Saccharomycetes;Saccharomycetales;Trichomonascaceae;Sugiyamaella;Sugiyamaella lignohabitans	0	0	0	1	1
Eukaryota;Eukaryota_Incertae_sedis;Apicomplexa;Aconoidasida;Haemosporida;Plasmodiidae;Plasmodium;Plasmodium gaboni	1	0	0	0	1
Eukaryota;Eukaryota_Incertae_sedis;Apicomplexa;Conoidasida;Eucoccidiorida;Sarcocystidae;Besnoitia;Besnoitia besnoiti	0	0	0	1	1
Eukaryota;Eukaryota_Incertae_sedis;Apicomplexa;Aconoidasida;Haemosporida;Plasmodiidae;Plasmodium;Plasmodium knowlesi	0	0	1	0	1
Eukaryota;Eukaryota_Incertae_sedis;Apicomplexa;Aconoidasida;Haemosporida;Plasmodiidae;Plasmodium;Plasmodium malariae	0	0	0	1	1
Archaea;Archaea_none;Euryarchaeota;Thermococci;Thermococcales;Thermococcaceae;Pyrococcus;Pyrococcus kukulkanii	0	0	0	1	1
Archaea;Archaea_none;Euryarchaeota;Methanopyri;Methanopyrales;Methanopyraceae;Methanopyrus;Methanopyrus kandleri	1	0	0	0	1
Eukaryota;Eukaryota_Incertae_sedis;Apicomplexa;Aconoidasida;Haemosporida;Plasmodiidae;Plasmodium;Plasmodium vivax	0	1	0	0	1
Eukaryota;Eukaryota_Incertae_sedis;Apicomplexa;Aconoidasida;Piroplasmida;Babesiidae;Babesia;Babesia bigemina	1	0	0	0	1
Eukaryota;Eukaryota_Incertae_sedis;Apicomplexa;Aconoidasida;Piroplasmida;Theileriidae;Theileria;Theileria annulata	0	1	0	0	1
Eukaryota;Eukaryota_Incertae_sedis;Apicomplexa;Aconoidasida;Piroplasmida;Theileriidae;Theileria;Theileria orientalis	1	0	0	0	1
Archaea;Archaea_none;Euryarchaeota;Methanomicrobia;Methanosarcinales;Methanosarcinaceae;Methanosarcina;Methanosarcina vacuolata	1	0	0	0	1
Eukaryota;Fungi;Ascomycota;Saccharomycetes;Saccharomycetales;Pichiaceae;Brettanomyces;Brettanomyces nanus	1	0	0	0	1
Eukaryota;Eukaryota_Incertae_sedis;Bacillariophyta;Coscinodiscophyceae;Thalassiosirales;Thalassiosiraceae;Thalassiosira;Thalassiosira pseudonana	0	1	0	0	1
Eukaryota;Eukaryota_Incertae_sedis;Euglenozoa;Kinetoplastea;Trypanosomatida;Trypanosomatidae;Trypanosoma;Trypanosoma brucei	0	0	0	1	1
Eukaryota;Fungi;Ascomycota;Eurotiomycetes;Eurotiales;Aspergillaceae;Aspergillus;Aspergillus chevalieri	0	0	1	0	1
Eukaryota;Fungi;Ascomycota;Eurotiomycetes;Eurotiales;Aspergillaceae;Aspergillus;Aspergillus fumigatus	0	0	1	0	1
Eukaryota;Fungi;Ascomycota;Eurotiomycetes;Eurotiales;Aspergillaceae;Aspergillus;Aspergillus luchuensis	0	0	0	1	1
Archaea;Archaea_none;Euryarchaeota;Methanomicrobia;Methanosarcinales;Methanosarcinaceae;Methanohalobium;Methanohalobium evestigatum	0	0	1	0	1
Eukaryota;Fungi;Ascomycota;Saccharomycetes;Saccharomycetales;Debaryomycetaceae;Candida;Candida dubliniensis	0	0	0	1	1
Eukaryota;Fungi;Ascomycota;Saccharomycetes;Saccharomycetales;Debaryomycetaceae;Candida;Candida orthopsilosis	0	1	0	0	1
Bacteria;Bacteria_none;Pseudomonadota;Gammaproteobacteria;Pseudomonadales;Pseudomonadaceae;Pseudomonas;Pseudomonas rhodesiae	0	0	0	1	1
Bacteria;Bacteria_none;Pseudomonadota;Gammaproteobacteria;Pseudomonadales;Pseudomonadaceae;Pseudomonas;Pseudomonas frederiksbergensis	1	0	0	0	1
Bacteria;Bacteria_none;Pseudomonadota;Epsilonproteobacteria;Campylobacterales;Arcobacteraceae;Malaciobacter;Malaciobacter halophilus	1	0	0	0	1
Bacteria;Bacteria_none;Pseudomonadota;Gammaproteobacteria;Alteromonadales;Shewanellaceae;Shewanella;Shewanella psychrophila	1	0	0	0	1
Bacteria;Bacteria_none;Pseudomonadota;Gammaproteobacteria;Alteromonadales;Pseudoalteromonadaceae;Pseudoalteromonas;Pseudoalteromonas piratica	0	1	0	0	1
Bacteria;Bacteria_none;Actinomycetota;Actinomycetes;Candidatus Nanopelagicales;Candidatus Nanopelagicaceae;Candidatus Nanopelagicus;Candidatus Nanopelagicus limnes	0	0	0	1	1
Bacteria;Bacteria_none;Pseudomonadota;Gammaproteobacteria;Alteromonadales;Pseudoalteromonadaceae;Pseudoalteromonas;Pseudoalteromonas sp. GCY	0	0	0	1	1
Bacteria;Bacteria_none;Pseudomonadota;Gammaproteobacteria;Alteromonadales;Shewanellaceae;Parashewanella;Parashewanella spongiae	0	0	0	1	1
Bacteria;Bacteria_none;Pseudomonadota;Gammaproteobacteria;Alteromonadales;Shewanellaceae;Parashewanella;Parashewanella tropica	0	1	0	0	1
Bacteria;Bacteria_none;Pseudomonadota;Gammaproteobacteria;Alteromonadales;Shewanellaceae;Shewanella;Shewanella avicenniae	0	0	0	1	1
Bacteria;Bacteria_none;Pseudomonadota;Gammaproteobacteria;Alteromonadales;Shewanellaceae;Shewanella;Shewanella frigidimarina	0	0	0	1	1
Bacteria;Bacteria_none;Actinomycetota;Actinomycetes;Kitasatosporales;Streptomycetaceae;Streptomyces;Streptomyces nodosus	0	1	0	0	1
Bacteria;Bacteria_none;Pseudomonadota;Gammaproteobacteria;Alteromonadales;Shewanellaceae;Shewanella;Shewanella sp. FJAT-51860	0	0	0	1	1
Bacteria;Bacteria_none;Pseudomonadota;Gammaproteobacteria;Alteromonadales;Pseudoalteromonadaceae;Flocculibacter;Flocculibacter collagenilyticus	0	0	0	1	1
Bacteria;Bacteria_none;Pseudomonadota;Gammaproteobacteria;Alteromonadales;Shewanellaceae;Shewanella;Shewanella violacea	0	0	0	1	1
Bacteria;Bacteria_none;Pseudomonadota;Gammaproteobacteria;Cardiobacteriales;Cardiobacteriaceae;Cardiobacterium;Cardiobacterium hominis	0	1	0	0	1
Bacteria;Bacteria_none;Pseudomonadota;Gammaproteobacteria;Cellvibrionales;Cellvibrionaceae;Marinimicrobium;Marinimicrobium sp. C6131	0	1	0	0	1
Bacteria;Bacteria_none;Pseudomonadota;Gammaproteobacteria;Chromatiales;Chromatiaceae;Nitrosococcus;Nitrosococcus watsonii	0	0	0	1	1
Bacteria;Bacteria_none;Pseudomonadota;Gammaproteobacteria;Chromatiales;Ectothiorhodospiraceae;Spiribacter;Spiribacter sp. E85	0	0	1	0	1
Bacteria;Bacteria_none;Pseudomonadota;Gammaproteobacteria;Chromatiales;Wenzhouxiangellaceae;Wenzhouxiangella;Wenzhouxiangella sp. AB-CW3	0	1	0	0	1
Bacteria;Bacteria_none;Pseudomonadota;Gammaproteobacteria;Enterobacterales;Enterobacteriaceae;Candidatus Blochmannia;Candidatus Blochmannia ocreatus	0	1	0	0	1
Bacteria;Bacteria_none;Actinomycetota;Actinomycetes;Bifidobacteriales;Bifidobacteriaceae;Parascardovia;Parascardovia denticolens	0	0	0	1	1
Bacteria;Bacteria_none;Pseudomonadota;Gammaproteobacteria;Alteromonadales;Pseudoalteromonadaceae;Pseudoalteromonas;Pseudoalteromonas luteoviolacea	0	0	0	1	1
Bacteria;Bacteria_none;Pseudomonadota;Gammaproteobacteria;Alteromonadales;Moritellaceae;Moritella;Moritella sp. 5	1	0	0	0	1
Bacteria;Bacteria_none;Actinomycetota;Actinomycetes;Bifidobacteriales;Bifidobacteriaceae;Bifidobacterium;Bifidobacterium pseudolongum	0	0	0	1	1
Bacteria;Bacteria_none;Pseudomonadota;Epsilonproteobacteria;Campylobacterales;Thiovulaceae;Sulfurimonas;Candidatus Sulfurimonas baltica	0	0	0	1	1
Bacteria;Bacteria_none;Pseudomonadota;Epsilonproteobacteria;Campylobacterales;Campylobacteraceae;Campylobacter;Campylobacter blaseri	0	0	0	1	1
Bacteria;Bacteria_none;Pseudomonadota;Epsilonproteobacteria;Campylobacterales;Campylobacteraceae;Campylobacter;Campylobacter concisus	0	1	0	0	1
Bacteria;Bacteria_none;Pseudomonadota;Epsilonproteobacteria;Campylobacterales;Campylobacteraceae;Campylobacter;Campylobacter curvus	0	0	0	1	1
Bacteria;Bacteria_none;Pseudomonadota;Epsilonproteobacteria;Campylobacterales;Campylobacteraceae;Campylobacter;Campylobacter geochelonis	0	0	0	1	1
Bacteria;Bacteria_none;Pseudomonadota;Epsilonproteobacteria;Campylobacterales;Campylobacteraceae;Campylobacter;Campylobacter hominis	0	1	0	0	1
Bacteria;Bacteria_none;Pseudomonadota;Epsilonproteobacteria;Campylobacterales;Campylobacteraceae;Campylobacter;Campylobacter mucosalis	0	1	0	0	1
Bacteria;Bacteria_none;Actinomycetota;Actinomycetes;Kitasatosporales;Streptomycetaceae;Kitasatospora;Kitasatospora sp. HUAS 3-15	0	1	0	0	1
Bacteria;Bacteria_none;Pseudomonadota;Epsilonproteobacteria;Campylobacterales;Campylobacteraceae;Campylobacter;Campylobacter ureolyticus	1	0	0	0	1
Bacteria;Bacteria_none;Pseudomonadota;Epsilonproteobacteria;Campylobacterales;Thiovulaceae;Sulfurimonas;Sulfurimonas lithotrophica	0	0	0	1	1
Bacteria;Bacteria_none;Pseudomonadota;Gammaproteobacteria;Alteromonadales;Colwelliaceae;Thalassotalea;Thalassotalea sp. HSM 43	0	0	1	0	1
Bacteria;Bacteria_none;Pseudomonadota;Gammaproteobacteria;Aeromonadales;Aeromonadaceae;Aeromonas;Aeromonas hydrophila	1	0	0	0	1
Bacteria;Bacteria_none;Pseudomonadota;Gammaproteobacteria;Aeromonadales;Aeromonadaceae;Aeromonas;Aeromonas schubertii	0	0	1	0	1
Bacteria;Bacteria_none;Pseudomonadota;Gammaproteobacteria;Aeromonadales;Aeromonadaceae;Aeromonas;Aeromonas veronii	0	0	0	1	1
Bacteria;Bacteria_none;Pseudomonadota;Gammaproteobacteria;Alteromonadales;Alteromonadaceae;Glaciecola;Glaciecola nitratireducens	0	0	0	1	1
Bacteria;Bacteria_none;Pseudomonadota;Gammaproteobacteria;Alteromonadales;Alteromonadaceae;Paraglaciecola;Paraglaciecola mesophila	0	0	1	0	1
Bacteria;Bacteria_none;Pseudomonadota;Gammaproteobacteria;Alteromonadales;Alteromonadaceae;Paraglaciecola;Paraglaciecola psychrophila	1	0	0	0	1
Bacteria;Bacteria_none;Pseudomonadota;Gammaproteobacteria;Alteromonadales;Alteromonadaceae;Paraneptunicella;Paraneptunicella aestuarii	0	1	0	0	1
Bacteria;Bacteria_none;Pseudomonadota;Gammaproteobacteria;Alteromonadales;Colwelliaceae;Colwellia;Colwellia sp. M166	0	0	0	1	1
Bacteria;Bacteria_none;Actinomycetota;Actinomycetes;Bifidobacteriales;Bifidobacteriaceae;Bifidobacterium;Bifidobacterium subtile	0	0	0	1	1
Bacteria;Bacteria_none;Pseudomonadota;Gammaproteobacteria;Enterobacterales;Enterobacteriaceae;Enterobacter;Enterobacter oligotrophicus	0	0	0	1	1
Bacteria;Bacteria_none;Pseudomonadota;Gammaproteobacteria;Pseudomonadales;Pseudomonadaceae;Pseudomonas;Pseudomonas fragi	0	1	0	0	1
Bacteria;Bacteria_none;Pseudomonadota;Gammaproteobacteria;Oceanospirillales;Halomonadaceae;Kushneria;Kushneria marisflavi	0	0	0	1	1
Bacteria;Bacteria_none;Pseudomonadota;Gammaproteobacteria;Moraxellales;Moraxellaceae;Acinetobacter;Acinetobacter sp. Y-23	1	0	0	0	1
Bacteria;Bacteria_none;Pseudomonadota;Gammaproteobacteria;Moraxellales;Moraxellaceae;Acinetobacter;Acinetobacter vivianii	0	1	0	0	1
Bacteria;Bacteria_none;Actinomycetota;Actinomycetes;Actinomycetales;Actinomycetaceae;Schaalia;Schaalia sp. JY-X169	0	0	0	1	1
Bacteria;Bacteria_none;Pseudomonadota;Gammaproteobacteria;Moraxellales;Moraxellaceae;Psychrobacter;Psychrobacter urativorans	0	1	0	0	1
Bacteria;Bacteria_none;Pseudomonadota;Gammaproteobacteria;Oceanospirillales;Alcanivoracaceae;Ketobacter;Ketobacter alkanivorans	0	0	1	0	1
Bacteria;Bacteria_none;Pseudomonadota;Gammaproteobacteria;Oceanospirillales;Halomonadaceae;Halomonas;Halomonas aestuarii	1	0	0	0	1
Bacteria;Bacteria_none;Pseudomonadota;Gammaproteobacteria;Oceanospirillales;Halomonadaceae;Halomonas;Halomonas campaniensis	0	0	0	1	1
Bacteria;Bacteria_none;Pseudomonadota;Gammaproteobacteria;Oceanospirillales;Halomonadaceae;Halomonas;Halomonas sp. A40-4	0	1	0	0	1
Bacteria;Bacteria_none;Pseudomonadota;Gammaproteobacteria;Orbales;Orbaceae;Gilliamella;Gilliamella apicola	1	0	0	0	1
Bacteria;Bacteria_none;Pseudomonadota;Gammaproteobacteria;Moraxellales;Moraxellaceae;Acinetobacter;Acinetobacter portensis	0	1	0	0	1
Bacteria;Bacteria_none;Pseudomonadota;Gammaproteobacteria;Pasteurellales;Pasteurellaceae;Pasteurella;Pasteurella canis	0	0	0	1	1
Bacteria;Bacteria_none;Pseudomonadota;Gammaproteobacteria;Pasteurellales;Pasteurellaceae;Pasteurella;Pasteurella dagmatis	0	0	0	1	1
Bacteria;Bacteria_none;Pseudomonadota;Gammaproteobacteria;Pseudomonadales;Marinobacteraceae;Marinobacter;Marinobacter fonticola	0	0	0	1	1
Bacteria;Bacteria_none;Pseudomonadota;Gammaproteobacteria;Pseudomonadales;Marinobacteraceae;Marinobacter;Marinobacter salsuginis	0	0	0	1	1
Bacteria;Bacteria_none;Pseudomonadota;Gammaproteobacteria;Pseudomonadales;Pseudomonadaceae;Pseudomonas;Pseudomonas antarctica	0	0	0	1	1
Bacteria;Bacteria_none;Pseudomonadota;Gammaproteobacteria;Pseudomonadales;Pseudomonadaceae;Pseudomonas;Pseudomonas brenneri	0	0	1	0	1
Bacteria;Bacteria_none;Pseudomonadota;Gammaproteobacteria;Pseudomonadales;Pseudomonadaceae;Pseudomonas;Pseudomonas chlororaphis	0	0	1	0	1
Bacteria;Bacteria_none;Actinomycetota;Actinomycetes;Actinomycetales;Actinomycetaceae;Actinomyces;Actinomyces naeslundii	1	0	0	0	1
Bacteria;Bacteria_none;Pseudomonadota;Gammaproteobacteria;Moraxellales;Moraxellaceae;Acinetobacter;Acinetobacter sp. WCHAc010034	0	0	0	1	1
Bacteria;Bacteria_none;Actinomycetota;Actinomycetes;Actinomycetales;Actinomycetaceae;Trueperella;Trueperella pyogenes	0	0	0	1	1
Bacteria;Bacteria_none;Pseudomonadota;Gammaproteobacteria;Enterobacterales;Enterobacteriaceae;Enterobacter;Enterobacter roggenkampii	0	1	0	0	1
Bacteria;Bacteria_none;Pseudomonadota;Gammaproteobacteria;Enterobacterales;Erwiniaceae;Tatumella;Tatumella citrea	1	0	0	0	1
Bacteria;Bacteria_none;Pseudomonadota;Gammaproteobacteria;Enterobacterales;Enterobacteriaceae;Enterobacteriaceae_Incertae_sedis;Enterobacteriaceae endosymbiont of Donacia simplex	0	0	0	1	1
Bacteria;Bacteria_none;Pseudomonadota;Gammaproteobacteria;Enterobacterales;Enterobacteriaceae;Escherichia;Escherichia albertii	0	0	1	0	1
Bacteria;Bacteria_none;Actinomycetota;Actinomycetes;Bifidobacteriales;Bifidobacteriaceae;Bifidobacterium;Bifidobacterium imperatoris	0	0	0	1	1
Bacteria;Bacteria_none;Pseudomonadota;Gammaproteobacteria;Enterobacterales;Enterobacteriaceae;Escherichia;Escherichia fergusonii	1	0	0	0	1
Bacteria;Bacteria_none;Actinomycetota;Actinomycetes;Bifidobacteriales;Bifidobacteriaceae;Bifidobacterium;Bifidobacterium eulemuris	0	0	1	0	1
Bacteria;Bacteria_none;Actinomycetota;Actinomycetes;Bifidobacteriales;Bifidobacteriaceae;Bifidobacterium;Bifidobacterium catenulatum	0	0	0	1	1
Bacteria;Bacteria_none;Pseudomonadota;Gammaproteobacteria;Enterobacterales;Erwiniaceae;Pantoea;Pantoea sp. CCBC3-3-1	1	0	0	0	1
Bacteria;Bacteria_none;Pseudomonadota;Gammaproteobacteria;Enterobacterales;Erwiniaceae;Pantoea;Pantoea sp. Z09	0	0	1	0	1
Bacteria;Bacteria_none;Pseudomonadota;Gammaproteobacteria;Enterobacterales;Morganellaceae;Photorhabdus;Photorhabdus thracensis	0	0	0	1	1
Bacteria;Bacteria_none;Pseudomonadota;Gammaproteobacteria;Moraxellales;Moraxellaceae;Acinetobacter;Acinetobacter bereziniae	0	0	1	0	1
Bacteria;Bacteria_none;Pseudomonadota;Gammaproteobacteria;Enterobacterales;Morganellaceae;Proteus;Proteus mirabilis	0	0	0	1	1
Bacteria;Bacteria_none;Actinomycetota;Actinomycetes;Actinomycetales;Actinomycetaceae;Varibaculum;Varibaculum prostatecancerukia	0	0	0	1	1
Bacteria;Bacteria_none;Pseudomonadota;Gammaproteobacteria;Enterobacterales;Morganellaceae;Xenorhabdus;Xenorhabdus doucetiae	0	0	0	1	1
Bacteria;Bacteria_none;Pseudomonadota;Gammaproteobacteria;Enterobacterales;Yersiniaceae;Yersinia;Yersinia rohdei	1	0	0	0	1
Bacteria;Bacteria_none;Pseudomonadota;Gammaproteobacteria;Gammaproteobacteria_Incertae_sedis;Gammaproteobacteria_Incertae_sedis_Incertae_sedis;Candidatus Pseudothioglobus;Candidatus Pseudothioglobus singularis	1	0	0	0	1
Bacteria;Bacteria_none;Pseudomonadota;Gammaproteobacteria;Legionellales;Legionellaceae;Legionella;Legionella jordanis	0	0	0	1	1
Bacteria;Bacteria_none;Pseudomonadota;Gammaproteobacteria;Legionellales;Legionellaceae;Legionella;Legionella pneumophila	0	0	1	0	1
Bacteria;Bacteria_none;Pseudomonadota;Gammaproteobacteria;Methylococcales;Methylococcaceae;Methylococcus;Methylococcus capsulatus	0	1	0	0	1
Bacteria;Bacteria_none;Fusobacteriota;Fusobacteriia;Fusobacteriales;Leptotrichiaceae;Streptobacillus;Streptobacillus moniliformis	0	0	0	1	1
Bacteria;Bacteria_none;Bacteroidota;Sphingobacteriia;Sphingobacteriales;Sphingobacteriaceae;Sphingobacterium;Sphingobacterium sp. LZ7M1	0	0	1	0	1
Bacteria;Bacteria_none;Fusobacteriota;Fusobacteriia;Fusobacteriales;Leptotrichiaceae;Sebaldella;Sebaldella termitidis	0	1	0	0	1
Bacteria;Bacteria_none;Bacillota;Bacilli;Lactobacillales;Streptococcaceae;Streptococcus;Streptococcus parauberis	0	0	1	0	1
Bacteria;Bacteria_none;Actinomycetota;Actinomycetes;Propionibacteriales;Nocardioidaceae;Nocardioides;Nocardioides sp. LMS-CY	1	0	0	0	1
Bacteria;Bacteria_none;Actinomycetota;Actinomycetes;Propionibacteriales;Nocardioidaceae;Nocardioides;Nocardioides sp. InS609-2	0	1	0	0	1
Bacteria;Bacteria_none;Bacillota;Bacilli;Lactobacillales;Streptococcaceae;Streptococcus;Streptococcus respiraculi	0	0	0	1	1
Bacteria;Bacteria_none;Bacillota;Bacilli;Lactobacillales;Streptococcaceae;Streptococcus;Streptococcus rubneri	0	0	0	1	1
Bacteria;Bacteria_none;Bacillota;Bacilli;Lactobacillales;Streptococcaceae;Streptococcus;Streptococcus ruminantium	1	0	0	0	1
Bacteria;Bacteria_none;Actinomycetota;Actinomycetes;Propionibacteriales;Nocardioidaceae;Nocardioides;Nocardioides rotundus	0	1	0	0	1
Bacteria;Bacteria_none;Actinomycetota;Actinomycetes;Propionibacteriales;Nocardioidaceae;Nocardioides;Nocardioides aromaticivorans	1	0	0	0	1
Bacteria;Bacteria_none;Bacillota;Bacilli;Lactobacillales;Streptococcaceae;Streptococcus;Streptococcus sp. 116-D4	0	1	0	0	1
Bacteria;Bacteria_none;Bacillota;Bacilli;Lactobacillales;Streptococcaceae;Streptococcus;Streptococcus sp. A12	1	0	0	0	1
Bacteria;Bacteria_none;Bacillota;Bacilli;Lactobacillales;Streptococcaceae;Streptococcus;Streptococcus sp. HSISM1	0	0	0	1	1
Bacteria;Bacteria_none;Bacillota;Bacilli;Lactobacillales;Streptococcaceae;Streptococcus;Streptococcus sp. HSISS3	0	0	1	0	1
Bacteria;Bacteria_none;Actinomycetota;Actinomycetes;Propionibacteriales;Nocardioidaceae;Marmoricola;Marmoricola scoriae	0	1	0	0	1
Bacteria;Bacteria_none;Actinomycetota;Actinomycetes;Nakamurellales;Nakamurellaceae;Nakamurella;Nakamurella multipartita	0	0	1	0	1
Bacteria;Bacteria_none;Bacillota;Bacilli;Lactobacillales;Streptococcaceae;Streptococcus;Streptococcus toyakuensis	1	0	0	0	1
Bacteria;Bacteria_none;Actinomycetota;Actinomycetes;Mycobacteriales;Nocardiaceae;Rhodococcus;Rhodococcus sp. Z13	0	1	0	0	1
Bacteria;Bacteria_none;Bacillota;Clostridia;Eubacteriales;Clostridiaceae;Caloramator;Caloramator sp. Dgby_cultured_2	0	0	0	1	1
Bacteria;Bacteria_none;Bacillota;Clostridia;Eubacteriales;Clostridiaceae;Clostridium;Clostridium aceticum	0	0	0	1	1
Bacteria;Bacteria_none;Bacillota;Clostridia;Eubacteriales;Clostridiaceae;Clostridium;Clostridium botulinum	0	0	0	1	1
Bacteria;Bacteria_none;Actinomycetota;Actinomycetes;Mycobacteriales;Nocardiaceae;Rhodococcus;Rhodococcus pyridinivorans	0	1	0	0	1
Bacteria;Bacteria_none;Actinomycetota;Actinomycetes;Propionibacteriales;Nocardioidaceae;Solicola;Solicola gregarius	0	0	0	1	1
Bacteria;Bacteria_none;Bacillota;Bacilli;Lactobacillales;Streptococcaceae;Streptococcus;Streptococcus parasuis	0	0	0	1	1
Bacteria;Bacteria_none;Fusobacteriota;Fusobacteriia;Fusobacteriales;Leptotrichiaceae;Leptotrichia;Leptotrichia wadei	0	0	1	0	1
Bacteria;Bacteria_none;Bacillota;Bacilli;Lactobacillales;Streptococcaceae;Streptococcus;Streptococcus oriscaviae	0	0	0	1	1
Bacteria;Bacteria_none;Bacillota;Bacilli;Lactobacillales;Lactobacillaceae;Latilactobacillus;Latilactobacillus sakei	0	0	1	0	1
Bacteria;Bacteria_none;Bacillota;Bacilli;Lactobacillales;Lactobacillaceae;Lentilactobacillus;Lentilactobacillus buchneri	0	1	0	0	1
Bacteria;Bacteria_none;Actinomycetota;Actinomycetes;Streptosporangiales;Nocardiopsaceae;Streptomonospora;Streptomonospora litoralis	0	1	0	0	1
Bacteria;Bacteria_none;Bacillota;Bacilli;Lactobacillales;Lactobacillaceae;Limosilactobacillus;Limosilactobacillus fermentum	0	1	0	0	1
Bacteria;Bacteria_none;Bacillota;Bacilli;Lactobacillales;Lactobacillaceae;Limosilactobacillus;Limosilactobacillus panis	0	1	0	0	1
Bacteria;Bacteria_none;Actinomycetota;Actinomycetes;Pseudonocardiales;Pseudonocardiaceae;Saccharomonospora;Saccharomonospora viridis	1	0	0	0	1
Bacteria;Bacteria_none;Actinomycetota;Actinomycetes;Pseudonocardiales;Pseudonocardiaceae;Pseudonocardia;Pseudonocardia sp. HH130630-07	1	0	0	0	1
Bacteria;Bacteria_none;Actinomycetota;Actinomycetes;Pseudonocardiales;Pseudonocardiaceae;Amycolatopsis;Amycolatopsis acidiphila	0	0	1	0	1
Bacteria;Bacteria_none;Bacillota;Bacilli;Lactobacillales;Lactobacillaceae;Oenococcus;Oenococcus sp. UCMA 16435	0	1	0	0	1
Bacteria;Bacteria_none;Bacillota;Bacilli;Lactobacillales;Lactobacillaceae;Pediococcus;Pediococcus acidilactici	0	0	0	1	1
Bacteria;Bacteria_none;Actinomycetota;Actinomycetes;Pseudonocardiales;Pseudonocardiaceae;Allokutzneria;Allokutzneria albata	0	1	0	0	1
Bacteria;Bacteria_none;Actinomycetota;Actinomycetes;Pseudonocardiales;Pseudonocardiaceae;Alloactinosynnema;Alloactinosynnema sp. L-07	0	0	0	1	1
Bacteria;Bacteria_none;Bacillota;Bacilli;Lactobacillales;Streptococcaceae;Lactococcus;Lactococcus taiwanensis	0	0	0	1	1
Bacteria;Bacteria_none;Actinomycetota;Actinomycetes;Pseudonocardiales;Pseudonocardiaceae;Actinokineospora;Actinokineospora sp. UTMC 2448	0	0	0	1	1
Bacteria;Bacteria_none;Actinomycetota;Actinomycetes;Pseudonocardiales;Pseudonocardiaceae;Actinoalloteichus;Actinoalloteichus sp. GBA129-24	0	1	0	0	1
Bacteria;Bacteria_none;Bacillota;Bacilli;Lactobacillales;Streptococcaceae;Streptococcus;Streptococcus equi	0	0	0	1	1
Bacteria;Bacteria_none;Actinomycetota;Actinomycetes;Propionibacteriales;Propionibacteriaceae;Microlunatus;Microlunatus sagamiharensis	0	0	0	1	1
Bacteria;Bacteria_none;Bacillota;Bacilli;Lactobacillales;Streptococcaceae;Streptococcus;Streptococcus gwangjuense	0	0	0	1	1
Bacteria;Bacteria_none;Bacillota;Bacilli;Lactobacillales;Streptococcaceae;Streptococcus;Streptococcus iniae	0	0	0	1	1
Bacteria;Bacteria_none;Bacillota;Clostridia;Eubacteriales;Clostridiaceae;Clostridium;Clostridium carboxidivorans	1	0	0	0	1
Bacteria;Bacteria_none;Bacillota;Clostridia;Eubacteriales;Clostridiaceae;Clostridium;Clostridium drakei	0	0	0	1	1
Bacteria;Bacteria_none;Actinomycetota;Actinomycetes;Mycobacteriales;Nocardiaceae;Rhodococcus;Rhodococcus coprophilus	0	0	0	1	1
Bacteria;Bacteria_none;Bacillota;Clostridia;Eubacteriales;Clostridiaceae;Clostridium;Clostridium gelidum	0	1	0	0	1
Bacteria;Bacteria_none;Bacillota;Clostridia;Eubacteriales;Oscillospiraceae;Acutalibacter;Acutalibacter muris	0	0	0	1	1
Bacteria;Bacteria_none;Actinomycetota;Actinomycetes;Mycobacteriales;Mycobacteriaceae;Mycobacterium;Mycobacterium ostraviense	0	0	1	0	1
Bacteria;Bacteria_none;Bacillota;Clostridia;Eubacteriales;Oscillospiraceae;Ruminiclostridium;Ruminiclostridium cellulolyticum	0	0	1	0	1
Bacteria;Bacteria_none;Bacillota;Clostridia;Eubacteriales;Peptococcaceae;Dehalobacterium;Dehalobacterium formicoaceticum	0	0	1	0	1
Bacteria;Bacteria_none;Bacillota;Clostridia;Eubacteriales;Peptostreptococcaceae;Filifactor;Filifactor alocis	0	0	0	1	1
Bacteria;Bacteria_none;Bacillota;Clostridia;Eubacteriales;Peptostreptococcaceae;Paeniclostridium;Paeniclostridium sordellii	1	0	0	0	1
Bacteria;Bacteria_none;Bacillota;Clostridia;Eubacteriales;Peptostreptococcaceae;Peptacetobacter;Peptacetobacter hiranonis	0	0	0	1	1
Bacteria;Bacteria_none;Bacillota;Clostridia;Eubacteriales;Peptostreptococcaceae;Peptoclostridium;Peptoclostridium acidaminophilum	0	1	0	0	1
Bacteria;Bacteria_none;Bacillota;Clostridia;Eubacteriales;Peptostreptococcaceae;Peptostreptococcus;Peptostreptococcus sp. CBA3647	0	0	0	1	1
Bacteria;Bacteria_none;Bacillota;Clostridia;Eubacteriales;Peptostreptococcaceae;Romboutsia;Romboutsia ilealis	0	0	0	1	1
Bacteria;Bacteria_none;Bacillota;Clostridia;Eubacteriales;Peptostreptococcaceae;Tepidibacter;Tepidibacter sp. 8C15b	0	0	0	1	1
Bacteria;Bacteria_none;Bacillota;Clostridia;Eubacteriales;Vallitaleaceae;Vallitalea;Vallitalea guaymasensis	0	1	0	0	1
Bacteria;Bacteria_none;Bacillota;Clostridia;Halanaerobiales;Halanaerobiaceae;Halanaerobium;Halanaerobium praevalens	0	0	0	1	1
Bacteria;Bacteria_none;Bacillota;Clostridia;Halanaerobiales;Halobacteroidaceae;Acetohalobium;Acetohalobium arabaticum	0	0	0	1	1
Bacteria;Bacteria_none;Bacillota;Clostridia;Halanaerobiales;Halobacteroidaceae;Halobacteroides;Halobacteroides halobius	0	1	0	0	1
Bacteria;Bacteria_none;Bacillota;Clostridia;Thermoanaerobacterales;Thermoanaerobacterales Family III. Incertae Sedis;Caldicellulosiruptor;Caldicellulosiruptor diazotrophicus	1	0	0	0	1
Bacteria;Bacteria_none;Bacillota;Clostridia;Thermosediminibacterales;Tepidanaerobacteraceae;Tepidanaerobacter;Tepidanaerobacter acetatoxydans	0	0	0	1	1
Bacteria;Bacteria_none;Bacillota;Clostridia;Thermosediminibacterales;Thermosediminibacteraceae;Thermosediminibacter;Thermosediminibacter oceani	0	0	0	1	1
Bacteria;Bacteria_none;Bacillota;Erysipelotrichia;Erysipelotrichales;Coprobacillaceae;Thomasclavelia;[Clostridium] innocuum	0	0	0	1	1
Bacteria;Bacteria_none;Bacillota;Clostridia;Eubacteriales;Lachnospiraceae;Tyzzerella;[Clostridium] colinum	0	0	0	1	1
Bacteria;Bacteria_none;Bacillota;Clostridia;Eubacteriales;Lachnospiraceae;Pseudobutyrivibrio;Pseudobutyrivibrio xylanivorans	0	0	0	1	1
Bacteria;Bacteria_none;Actinomycetota;Actinomycetes;Mycobacteriales;Mycobacteriaceae;Mycolicibacterium;Mycolicibacterium aurum	1	0	0	0	1
Bacteria;Bacteria_none;Bacillota;Clostridia;Eubacteriales;Clostridiaceae;Sarcina;Sarcina sp. JB2	0	0	0	1	1
Bacteria;Bacteria_none;Actinomycetota;Actinomycetes;Mycobacteriales;Nocardiaceae;Nocardia;Nocardia farcinica	0	0	0	1	1
Bacteria;Bacteria_none;Bacillota;Clostridia;Eubacteriales;Clostridiaceae;Clostridium;Clostridium saccharobutylicum	0	0	0	1	1
Bacteria;Bacteria_none;Bacillota;Clostridia;Eubacteriales;Clostridiaceae;Clostridium;Clostridium sp. BJN0001	0	0	0	1	1
Bacteria;Bacteria_none;Bacillota;Clostridia;Eubacteriales;Clostridiaceae;Clostridium;Clostridium sp. DL-VIII	0	0	0	1	1
Bacteria;Bacteria_none;Bacillota;Clostridia;Eubacteriales;Clostridiaceae;Crassaminicella;Crassaminicella profunda	0	0	0	1	1
Bacteria;Bacteria_none;Bacillota;Clostridia;Eubacteriales;Clostridiaceae;Crassaminicella;Crassaminicella thermophila	0	0	1	0	1
Bacteria;Bacteria_none;Bacillota;Clostridia;Eubacteriales;Clostridiaceae;Geosporobacter;Geosporobacter ferrireducens	0	0	0	1	1
Bacteria;Bacteria_none;Bacillota;Clostridia;Eubacteriales;Clostridiaceae;Paraclostridium;Paraclostridium bifermentans	0	0	0	1	1
Bacteria;Bacteria_none;Bacillota;Clostridia;Eubacteriales;Desulfitobacteriaceae;Desulfitobacterium;Desulfitobacterium metallireducens	0	0	0	1	1
Bacteria;Bacteria_none;Bacillota;Clostridia;Eubacteriales;Lachnospiraceae;Enterocloster;Enterocloster bolteae	0	0	0	1	1
Bacteria;Bacteria_none;Bacillota;Clostridia;Eubacteriales;Eubacteriaceae;Alkalibacter;Alkalibacter rhizosphaerae	0	0	0	1	1
Bacteria;Bacteria_none;Actinomycetota;Actinomycetes;Mycobacteriales;Nocardiaceae;Nocardia;Nocardia asteroides	1	0	0	0	1
Bacteria;Bacteria_none;Bacillota;Clostridia;Eubacteriales;Eubacteriales_Incertae_sedis;Fenollaria;Fenollaria massiliensis	0	0	0	1	1
Bacteria;Bacteria_none;Actinomycetota;Actinomycetes;Mycobacteriales;Mycobacteriaceae;Mycolicibacterium;Mycolicibacterium psychrotolerans	0	0	0	1	1
Bacteria;Bacteria_none;Bacillota;Clostridia;Eubacteriales;Lachnospiraceae;Anaerostipes;Anaerostipes hadrus	0	0	0	1	1
Bacteria;Bacteria_none;Bacillota;Clostridia;Eubacteriales;Lachnospiraceae;Blautia;Blautia obeum	0	0	0	1	1
Bacteria;Bacteria_none;Bacillota;Clostridia;Eubacteriales;Lachnospiraceae;Blautia;Blautia pseudococcoides	0	0	0	1	1
Bacteria;Bacteria_none;Bacillota;Clostridia;Eubacteriales;Lachnospiraceae;Butyrivibrio;Butyrivibrio crossotus	0	1	0	0	1
Bacteria;Bacteria_none;Bacillota;Bacilli;Lactobacillales;Lactobacillaceae;Lactobacillus;Lactobacillus ultunensis	0	1	0	0	1
Bacteria;Bacteria_none;Actinomycetota;Actinomycetes;Streptosporangiales;Streptosporangiaceae;Nonomuraea;Nonomuraea coxensis	0	1	0	0	1
Bacteria;Bacteria_none;Bacillota;Bacilli;Lactobacillales;Lactobacillaceae;Lactobacillus;Lactobacillus sp. PV034	0	0	0	1	1
Bacteria;Bacteria_none;Bacillota;Bacilli;Bacillales;Planococcaceae;Planococcus;Planococcus halocryophilus	0	0	1	0	1
Bacteria;Bacteria_none;Bacillota;Bacilli;Bacillales;Bacillaceae;Sutcliffiella;Sutcliffiella horikoshii	0	0	0	1	1
Bacteria;Bacteria_none;Bacillota;Bacilli;Bacillales;Bacillales_Incertae_sedis;Exiguobacterium;Exiguobacterium sp. AT1b	0	0	1	0	1
Bacteria;Bacteria_none;Bacillota;Bacilli;Bacillales;Bacillales_Incertae_sedis;Gemella;Gemella morbillorum	0	0	0	1	1
Bacteria;Bacteria_none;Bacillota;Bacilli;Bacillales;Bacillaceae;Anaerobacillus;Anaerobacillus isosaccharinicus	0	0	0	1	1
Bacteria;Bacteria_none;Bacillota;Bacilli;Bacillales;Bacillaceae;Alkalihalobacillus;Alkalihalobacillus sp. LMS6	0	0	0	1	1
Bacteria;Bacteria_none;Bacillota;Bacilli;Bacillales;Bacillaceae;Alkalihalobacillus;Alkalihalobacillus krulwichiae	0	0	0	1	1
Bacteria;Bacteria_none;Bacillota;Bacilli;Bacillales;Paenibacillaceae;Aneurinibacillus;Aneurinibacillus sp. Ricciae_BoGa-3	0	1	0	0	1
Bacteria;Bacteria_none;Bacillota;Bacilli;Bacillales;Paenibacillaceae;Cohnella;Cohnella candidum	0	1	0	0	1
Bacteria;Bacteria_none;Bacillota;Bacilli;Bacillales;Paenibacillaceae;Paenibacillus;Paenibacillus bovis	0	0	1	0	1
Bacteria;Bacteria_none;Bacillota;Bacilli;Bacillales;Paenibacillaceae;Paenibacillus;Paenibacillus cellulosilyticus	0	1	0	0	1
Bacteria;Bacteria_none;Bacillota;Bacilli;Bacillales;Alicyclobacillaceae;Alicyclobacillus;Alicyclobacillus fastidiosus	1	0	0	0	1
Bacteria;Bacteria_none;Bacillota;Bacilli;Bacillales;Paenibacillaceae;Paenibacillus;Paenibacillus lautus	0	0	0	1	1
Bacteria;Bacteria_none;Bacillota;Bacilli;Bacillales;Paenibacillaceae;Paenibacillus;Paenibacillus naphthalenovorans	0	1	0	0	1
Bacteria;Bacteria_none;Bacillota;Bacilli;Bacillales;Paenibacillaceae;Paenibacillus;Paenibacillus pabuli	0	0	0	1	1
Bacteria;Bacteria_none;Bacillota;Bacilli;Bacillales;Paenibacillaceae;Paenibacillus;Paenibacillus polymyxa	0	0	0	1	1
Bacteria;Bacteria_none;Bacillota;Bacilli;Bacillales;Paenibacillaceae;Paenibacillus;Paenibacillus sp. BIHB4019	0	1	0	0	1
Bacteria;Bacteria_none;Bacillota;Bacilli;Bacillales;Paenibacillaceae;Paenibacillus;Paenibacillus sp. FSL R7-0331	1	0	0	0	1
Bacteria;Bacteria_none;Bacillota;Bacilli;Bacillales;Paenibacillaceae;Paenibacillus;Paenibacillus sp. PK3_47	0	1	0	0	1
Bacteria;Bacteria_none;Bacillota;Bacilli;Bacillales;Planococcaceae;Kurthia;Kurthia sp. 11kri321	0	0	1	0	1
Bacteria;Bacteria_none;Bacillota;Bacilli;Bacillales;Bacillaceae;Salicibibacter;Salicibibacter halophilus	0	0	0	1	1
Bacteria;Bacteria_none;Bacillota;Bacilli;Bacillales;Bacillaceae;Priestia;Priestia megaterium	0	0	1	0	1
Bacteria;Bacteria_none;Bacillota;Bacilli;Bacillales;Bacillaceae;Priestia;Priestia koreensis	0	0	1	0	1
Bacteria;Bacteria_none;Bacillota;Bacilli;Bacillales;Bacillaceae;Fictibacillus;Fictibacillus phosphorivorans	0	0	1	0	1
Bacteria;Bacteria_none;Bacillota;Bacilli;Bacillales;Bacillaceae;Bacillus;Bacillus sp. BD59S	0	0	1	0	1
Bacteria;Bacteria_none;Bacillota;Bacilli;Bacillales;Bacillaceae;Bacillus;Bacillus sp. N1-1	0	1	0	0	1
Bacteria;Bacteria_none;Bacillota;Bacilli;Bacillales;Bacillaceae;Bacillus;Bacillus pseudomycoides	0	0	1	0	1
Bacteria;Bacteria_none;Bacillota;Bacilli;Bacillales;Bacillaceae;Bacillus;Bacillus tequilensis	0	0	0	1	1
Bacteria;Bacteria_none;Bacillota;Bacilli;Bacillales;Bacillaceae;Bacillus;Bacillus thuringiensis	0	1	0	0	1
Bacteria;Bacteria_none;Bacillota;Bacilli;Bacillales;Bacillaceae;Bacillus;Bacillus mycoides	0	0	0	1	1
Bacteria;Bacteria_none;Bacillota;Bacilli;Bacillales;Bacillaceae;Cytobacillus;Cytobacillus firmus	1	0	0	0	1
Bacteria;Bacteria_none;Bacillota;Bacilli;Bacillales;Bacillaceae;Evansella;Evansella cellulosilytica	0	0	1	0	1
Bacteria;Bacteria_none;Bacillota;Bacilli;Bacillales;Bacillaceae;Halalkalibacterium (ex Joshi et al. 2022);Halalkalibacterium halodurans	0	0	0	1	1
Bacteria;Bacteria_none;Bacillota;Bacilli;Bacillales;Bacillaceae;Parageobacillus;Parageobacillus toebii	0	1	0	0	1
Bacteria;Bacteria_none;Bacillota;Bacilli;Bacillales;Bacillaceae;Halobacillus;Halobacillus litoralis	0	0	1	0	1
Bacteria;Bacteria_none;Bacillota;Bacilli;Bacillales;Bacillaceae;Lysinibacillus;Lysinibacillus sphaericus	0	1	0	0	1
Bacteria;Bacteria_none;Bacillota;Bacilli;Bacillales;Bacillaceae;Lysinibacillus;Lysinibacillus timonensis	0	0	0	1	1
Bacteria;Bacteria_none;Bacillota;Bacilli;Bacillales;Bacillaceae;Mesobacillus;Mesobacillus sp. S13	0	0	0	1	1
Bacteria;Bacteria_none;Bacillota;Bacilli;Bacillales;Bacillaceae;Neobacillus;Neobacillus mesonae	0	0	1	0	1
Bacteria;Bacteria_none;Bacillota;Bacilli;Bacillales;Bacillaceae;Neobacillus;Neobacillus sp. Marseille-Q6967	1	0	0	0	1
Bacteria;Bacteria_none;Bacillota;Bacilli;Bacillales;Bacillaceae;Niallia;Niallia sp. Man26	0	0	1	0	1
Bacteria;Bacteria_none;Bacillota;Bacilli;Bacillales;Bacillaceae;Niallia;Niallia sp. RD1	0	0	0	1	1
Bacteria;Bacteria_none;Bacillota;Bacilli;Bacillales;Planococcaceae;Planococcus;Planococcus antarcticus	0	0	0	1	1
Bacteria;Bacteria_none;Bacillota;Bacilli;Bacillales;Planococcaceae;Sporosarcina;Sporosarcina sp. Marseille-Q4063	1	0	0	0	1
Bacteria;Bacteria_none;Bacillota;Bacilli;Lactobacillales;Lactobacillaceae;Lactobacillus;Lactobacillus paragasseri	0	1	0	0	1
Bacteria;Bacteria_none;Bacillota;Bacilli;Bacillales;Sporolactobacillaceae;Sporolactobacillus;Sporolactobacillus terrae	0	0	0	1	1
Bacteria;Bacteria_none;Bacillota;Bacilli;Lactobacillales;Enterococcaceae;Enterococcus;Enterococcus raffinosus	0	0	0	1	1
Bacteria;Bacteria_none;Bacillota;Bacilli;Lactobacillales;Enterococcaceae;Enterococcus;Enterococcus saigonensis	0	0	1	0	1
Bacteria;Bacteria_none;Bacillota;Bacilli;Lactobacillales;Enterococcaceae;Vagococcus;Vagococcus zengguangii	0	0	0	1	1
Bacteria;Bacteria_none;Bacillota;Bacilli;Lactobacillales;Lactobacillaceae;Bombilactobacillus;Bombilactobacillus thymidiniphilus	0	0	0	1	1
Bacteria;Bacteria_none;Actinomycetota;Coriobacteriia;Eggerthellales;Eggerthellaceae;Raoultibacter;Raoultibacter timonensis	0	0	0	1	1
Bacteria;Bacteria_none;Bacillota;Bacilli;Lactobacillales;Lactobacillaceae;Furfurilactobacillus;Furfurilactobacillus rossiae	0	0	1	0	1
Bacteria;Bacteria_none;Bacillota;Bacilli;Lactobacillales;Lactobacillaceae;Lacticaseibacillus;Lacticaseibacillus sp. KACC 23028	0	0	1	0	1
Bacteria;Bacteria_none;Actinomycetota;Coriobacteriia;Coriobacteriales;Coriobacteriaceae;Collinsella;Collinsella sp. zg1085	0	0	0	1	1
Bacteria;Bacteria_none;Bacillota;Bacilli;Lactobacillales;Lactobacillaceae;Lactobacillus;Lactobacillus apis	0	1	0	0	1
Bacteria;Bacteria_none;Actinomycetota;Coriobacteriia;Coriobacteriales;Atopobiaceae;Parafannyhessea;Parafannyhessea umbonata	0	0	0	1	1
Bacteria;Bacteria_none;Actinomycetota;Coriobacteriia;Coriobacteriales;Atopobiaceae;Leptogranulimonas;Leptogranulimonas caecicola	0	0	1	0	1
Bacteria;Bacteria_none;Actinomycetota;Coriobacteriia;Coriobacteriales;Atopobiaceae;Lancefieldella;Lancefieldella parvula	0	0	0	1	1
Bacteria;Bacteria_none;Actinomycetota;Coriobacteriia;Coriobacteriales;Atopobiaceae;Atopobium;Atopobium sp. oral taxon 416	0	0	0	1	1
Bacteria;Bacteria_none;Bacillota;Bacilli;Lactobacillales;Lactobacillaceae;Lactobacillus;Lactobacillus intestinalis	0	1	0	0	1
Bacteria;Bacteria_none;Actinomycetota;Actinomycetes;Streptosporangiales;Thermomonosporaceae;Actinomadura;Actinomadura madurae	1	0	0	0	1
Bacteria;Bacteria_none;Actinomycetota;Actinomycetes;Streptosporangiales;Streptosporangiaceae;Streptosporangium;Streptosporangium sp. 'caverna'	0	1	0	0	1
Bacteria;Bacteria_none;Actinomycetota;Actinomycetes;Streptosporangiales;Streptosporangiaceae;Nonomuraea;Nonomuraea sp. ATCC 55076	0	1	0	0	1
Bacteria;Bacteria_none;Bacillota;Bacilli;Lactobacillales;Lactobacillaceae;Lactobacillus;Lactobacillus kullabergensis	0	1	0	0	1
Bacteria;Bacteria_none;Bacillota;Bacilli;Lactobacillales;Lactobacillaceae;Lactobacillus;Lactobacillus panisapium	0	0	0	1	1
Bacteria;Bacteria_none;Actinomycetota;Nitriliruptoria;Egibacterales;Egibacteraceae;Egibacter;Egibacter rhizosphaerae	0	0	0	1	1
Bacteria;Bacteria_none;Bacillota;Bacilli;Lactobacillales;Enterococcaceae;Enterococcus;Enterococcus faecalis	0	1	0	0	1
Bacteria;Bacteria_none;Bacillota;Bacilli;Lactobacillales;Enterococcaceae;Enterococcus;Enterococcus cecorum	0	0	1	0	1
Bacteria;Bacteria_none;Bacillota;Bacilli;Bacillales;Staphylococcaceae;Staphylococcus;Staphylococcus lugdunensis	0	1	0	0	1
Bacteria;Bacteria_none;Bacillota;Bacilli;Bacillales;Staphylococcaceae;Mammaliicoccus;Mammaliicoccus stepanovicii	1	0	0	0	1
Bacteria;Bacteria_none;Bacillota;Bacilli;Bacillales;Alicyclobacillaceae;Alicyclobacillus;Alicyclobacillus dauci	0	0	0	1	1
Bacteria;Bacteria_none;Armatimonadetes;Chthonomonadetes;Chthonomonadales;Chthonomonadaceae;Chthonomonas;Chthonomonas calidirosea	0	1	0	0	1
Bacteria;Bacteria_none;Bacillota;Bacilli;Bacillales;Staphylococcaceae;Staphylococcus;Staphylococcus auricularis	0	1	0	0	1
Bacteria;Bacteria_none;Aquificota;Aquificae;Aquificales;Hydrogenothermaceae;Sulfurihydrogenibium;Sulfurihydrogenibium azorense	0	0	0	1	1
Bacteria;Bacteria_none;Bacillota;Bacilli;Bacillales;Staphylococcaceae;Staphylococcus;Staphylococcus condimenti	0	1	0	0	1
Bacteria;Bacteria_none;Aquificota;Aquificae;Aquificales;Hydrogenothermaceae;Persephonella;Persephonella marina	0	0	0	1	1
Bacteria;Bacteria_none;Bacillota;Bacilli;Bacillales;Staphylococcaceae;Staphylococcus;Staphylococcus haemolyticus	0	0	0	1	1
Bacteria;Bacteria_none;Actinomycetota;Thermoleophilia;Solirubrobacterales;Conexibacteraceae;Conexibacter;Conexibacter woesei	0	0	0	1	1
Bacteria;Bacteria_none;Bacillota;Bacilli;Lactobacillales;Enterococcaceae;Enterococcus;Enterococcus avium	0	0	0	1	1
Bacteria;Bacteria_none;Bacillota;Bacilli;Bacillales;Staphylococcaceae;Staphylococcus;Staphylococcus sp. IVB6181	1	0	0	0	1
Bacteria;Bacteria_none;Bacillota;Bacilli;Bacillales;Staphylococcaceae;Staphylococcus;Staphylococcus warneri	0	0	0	1	1
Bacteria;Bacteria_none;Bacillota;Bacilli;Bacillales;Thermoactinomycetaceae;Thermoactinomyces;Thermoactinomyces vulgaris	0	0	1	0	1
Bacteria;Bacteria_none;Actinomycetota;Thermoleophilia;Solirubrobacterales;Conexibacteraceae;Conexibacter;Conexibacter sp. DBS9H8	0	1	0	0	1
Bacteria;Bacteria_none;Bacillota;Bacilli;Lactobacillales;Aerococcaceae;Aerococcus;Aerococcus urinae	1	0	0	0	1
Bacteria;Bacteria_none;Bacillota;Bacilli;Lactobacillales;Carnobacteriaceae;Dolosigranulum;Dolosigranulum pigrum	0	0	0	1	1
Bacteria;Bacteria_none;Bacillota;Bacilli;Lactobacillales;Carnobacteriaceae;Granulicatella;Granulicatella adiacens	0	0	1	0	1
Bacteria;Bacteria_none;Actinomycetota;Thermoleophilia;Miltoncostaeales;Miltoncostaeaceae;Miltoncostaea;Miltoncostaea oceani	0	0	0	1	1
Bacteria;Bacteria_none;Actinomycetota;Actinomycetes;Mycobacteriales;Mycobacteriaceae;Mycobacterium;Mycobacterium marinum	0	0	0	1	1
Bacteria;Bacteria_none;Bacillota;Erysipelotrichia;Erysipelotrichales;Erysipelotrichaceae;Erysipelothrix;Erysipelothrix larvae	0	0	0	1	1
Bacteria;Bacteria_none;Bacillota;Erysipelotrichia;Erysipelotrichales;Erysipelotrichaceae;Erysipelothrix;Erysipelothrix piscisicarius	0	0	0	1	1
Bacteria;Bacteria_none;Bacteroidota;Sphingobacteriia;Sphingobacteriales;Sphingobacteriaceae;Pedobacter;Pedobacter suwonensis	0	0	0	1	1
Bacteria;Bacteria_none;Bacteroidota;Flavobacteriia;Flavobacteriales;Flavobacteriaceae;Seonamhaeicola;Seonamhaeicola sp. S2-3	1	0	0	0	1
Bacteria;Bacteria_none;Actinomycetota;Actinomycetes;Kitasatosporales;Streptomycetaceae;Streptomyces;Streptomyces tirandamycinicus	0	0	0	1	1
Bacteria;Bacteria_none;Bacteroidota;Flavobacteriia;Flavobacteriales;Flavobacteriaceae;Zunongwangia;Zunongwangia sp. HRR-M8	0	0	0	1	1
Bacteria;Bacteria_none;Bacteroidota;Flavobacteriia;Flavobacteriales;Weeksellaceae;Chryseobacterium;Chryseobacterium balustinum	1	0	0	0	1
Bacteria;Bacteria_none;Bacteroidota;Flavobacteriia;Flavobacteriales;Weeksellaceae;Chryseobacterium;Chryseobacterium gleum	0	0	1	0	1
Bacteria;Bacteria_none;Bacteroidota;Flavobacteriia;Flavobacteriales;Weeksellaceae;Chryseobacterium;Chryseobacterium oranimense	0	0	0	1	1
Bacteria;Bacteria_none;Bacteroidota;Flavobacteriia;Flavobacteriales;Weeksellaceae;Chryseobacterium;Chryseobacterium oryzae	0	0	1	0	1
Bacteria;Bacteria_none;Actinomycetota;Actinomycetes;Kitasatosporales;Streptomycetaceae;Streptomyces;Streptomyces sp. Z423-1	0	0	1	0	1
Bacteria;Bacteria_none;Bacteroidota;Flavobacteriia;Flavobacteriales;Weeksellaceae;Chryseobacterium;Chryseobacterium sp. SNU WT5	0	0	0	1	1
Bacteria;Bacteria_none;Bacteroidota;Flavobacteriia;Flavobacteriales;Weeksellaceae;Chryseobacterium;Chryseobacterium taklimakanense	0	0	0	1	1
Bacteria;Bacteria_none;Bacteroidota;Flavobacteriia;Flavobacteriales;Weeksellaceae;Elizabethkingia;Elizabethkingia anophelis	0	0	1	0	1
Bacteria;Bacteria_none;Actinomycetota;Actinomycetes;Kitasatosporales;Streptomycetaceae;Streptomyces;Streptomyces sp. WY228	0	0	1	0	1
Bacteria;Bacteria_none;Bacteroidota;Flavobacteriia;Flavobacteriales;Weeksellaceae;Faecalibacter;Faecalibacter bovis	1	0	0	0	1
Bacteria;Bacteria_none;Actinomycetota;Actinomycetes;Kitasatosporales;Streptomycetaceae;Streptomyces;Streptomyces sp. T12	0	1	0	0	1
Bacteria;Bacteria_none;Bacteroidota;Sphingobacteriia;Sphingobacteriales;Sphingobacteriaceae;Mucilaginibacter;Mucilaginibacter gotjawali	0	0	0	1	1
Bacteria;Bacteria_none;Bacteroidota;Sphingobacteriia;Sphingobacteriales;Sphingobacteriaceae;Mucilaginibacter;Mucilaginibacter xinganensis	0	0	1	0	1
Bacteria;Bacteria_none;Bacteroidota;Sphingobacteriia;Sphingobacteriales;Sphingobacteriaceae;Olivibacter;Olivibacter sp. LS-1	0	0	1	0	1
Bacteria;Bacteria_none;Bacteroidota;Sphingobacteriia;Sphingobacteriales;Sphingobacteriaceae;Pedobacter;Pedobacter cryoconitis	0	0	0	1	1
Bacteria;Bacteria_none;Actinomycetota;Actinomycetes;Kitasatosporales;Streptomycetaceae;Streptomyces;Streptomyces sp. SM18	0	1	0	0	1
Bacteria;Bacteria_none;Bacteroidota;Flavobacteriia;Flavobacteriales;Flavobacteriaceae;Salegentibacter;Salegentibacter salegens	0	0	0	1	1
Bacteria;Bacteria_none;Bacteroidota;Flavobacteriia;Flavobacteriales;Flavobacteriaceae;Salegentibacter;Salegentibacter mishustinae	0	0	1	0	1
Bacteria;Bacteria_none;Bacteroidota;Flavobacteriia;Flavobacteriales;Flavobacteriaceae;Rasiella;Rasiella rasia	0	0	0	1	1
Bacteria;Bacteria_none;Bacteroidota;Flavobacteriia;Flavobacteriales;Flavobacteriaceae;Flavobacterium;Flavobacterium sp. KK2020170	0	0	0	1	1
Bacteria;Bacteria_none;Bacteroidota;Flavobacteriia;Flavobacteriales;Flavobacteriaceae;Flavobacterium;Flavobacterium channae	0	0	0	1	1
Bacteria;Bacteria_none;Bacteroidota;Flavobacteriia;Flavobacteriales;Flavobacteriaceae;Flavobacterium;Flavobacterium davisii	1	0	0	0	1
Bacteria;Bacteria_none;Bacteroidota;Flavobacteriia;Flavobacteriales;Flavobacteriaceae;Flavobacterium;Flavobacterium faecale	0	1	0	0	1
Bacteria;Bacteria_none;Bacteroidota;Flavobacteriia;Flavobacteriales;Flavobacteriaceae;Flavobacterium;Flavobacterium haoranii	0	0	0	1	1
Bacteria;Bacteria_none;Bacteroidota;Flavobacteriia;Flavobacteriales;Flavobacteriaceae;Flavobacterium;Flavobacterium psychrophilum	0	0	0	1	1
Bacteria;Bacteria_none;Bacteroidota;Flavobacteriia;Flavobacteriales;Flavobacteriaceae;Flavobacterium;Flavobacterium sangjuense	0	0	0	1	1
Bacteria;Bacteria_none;Actinomycetota;Actinomycetes;Micrococcales;Cellulomonadaceae;Cellulomonas;Cellulomonas wangleii	0	0	1	0	1
Bacteria;Bacteria_none;Bacteroidota;Flavobacteriia;Flavobacteriales;Flavobacteriaceae;Flavobacterium;Flavobacterium sp. IMCC36792	0	0	0	1	1
Bacteria;Bacteria_none;Bacteroidota;Flavobacteriia;Flavobacteriales;Flavobacteriaceae;Flavobacterium;Flavobacterium sp. MDT1-60	1	0	0	0	1
Bacteria;Bacteria_none;Bacteroidota;Flavobacteriia;Flavobacteriales;Flavobacteriaceae;Polaribacter;Polaribacter vadi	0	0	0	1	1
Bacteria;Bacteria_none;Actinomycetota;Actinomycetes;Micrococcales;Brevibacteriaceae;Brevibacterium;Brevibacterium sp. CS2	0	0	0	1	1
Bacteria;Bacteria_none;Bacteroidota;Flavobacteriia;Flavobacteriales;Flavobacteriaceae;Flavobacterium;Flavobacterium sp. N1994	1	0	0	0	1
Bacteria;Bacteria_none;Bacteroidota;Flavobacteriia;Flavobacteriales;Flavobacteriaceae;Flavobacterium;Flavobacterium sp. N2013	0	0	0	1	1
Bacteria;Bacteria_none;Actinomycetota;Actinomycetes;Micrococcales;Brevibacteriaceae;Brevibacterium;Brevibacterium oceani	0	0	0	1	1
Bacteria;Bacteria_none;Bacteroidota;Flavobacteriia;Flavobacteriales;Flavobacteriaceae;Gramella;Gramella forsetii	0	0	0	1	1
Bacteria;Bacteria_none;Actinomycetota;Actinomycetes;Micrococcales;Brevibacteriaceae;Brevibacterium;Brevibacterium linens	0	0	0	1	1
Bacteria;Bacteria_none;Actinomycetota;Actinomycetes;Micrococcales;Beutenbergiaceae;Beutenbergia;Beutenbergia cavernae	0	1	0	0	1
Bacteria;Bacteria_none;Actinomycetota;Actinomycetes;Kitasatosporales;Streptomycetaceae;Streptomyces;Streptomyces zhihengii	0	0	0	1	1
Bacteria;Bacteria_none;Bacteroidota;Sphingobacteriia;Sphingobacteriales;Sphingobacteriaceae;Pedobacter;Pedobacter sp. G11	0	1	0	0	1
Bacteria;Bacteria_none;Bacillota;Bacilli;Bacillales;Bacillaceae;Bacillus;Bacillus shivajii	0	0	0	1	1
Bacteria;Bacteria_none;Bacteroidota;Flavobacteriia;Flavobacteriales;Flavobacteriaceae;Croceibacter;Croceibacter atlanticus	0	0	1	0	1
Bacteria;Bacteria_none;Caldiserica;Caldisericia;Caldisericales;Caldisericaceae;Caldisericum;Caldisericum exile	0	0	0	1	1
Bacteria;Bacteria_none;Cyanobacteriota;Cyanophyceae;Oscillatoriales;Microcoleaceae;Planktothrix;Planktothrix agardhii	0	1	0	0	1
Bacteria;Bacteria_none;Actinomycetota;Actinomycetes;Kitasatosporales;Streptomycetaceae;Streptomyces;Streptomyces sp. Mg1	0	1	0	0	1
Bacteria;Bacteria_none;Cyanobacteriota;Cyanophyceae;Pseudanabaenales;Leptolyngbyaceae;Leptolyngbya;Leptolyngbya boryana	0	1	0	0	1
Bacteria;Bacteria_none;Actinomycetota;Actinomycetes;Kitasatosporales;Streptomycetaceae;Streptomyces;Streptomyces sp. HUAS 15-9	1	0	0	0	1
Bacteria;Bacteria_none;Actinomycetota;Actinomycetes;Kitasatosporales;Streptomycetaceae;Streptomyces;Streptomyces sp. HUAS 14-6	0	1	0	0	1
Bacteria;Bacteria_none;Actinomycetota;Actinomycetes;Kitasatosporales;Streptomycetaceae;Streptomyces;Streptomyces sp. GMY02	0	1	0	0	1
Bacteria;Bacteria_none;Cyanobacteriota;Cyanophyceae;Synechococcales;Synechococcaceae;Synechococcus;Synechococcus sp. A15-127	0	0	0	1	1
Bacteria;Bacteria_none;Cyanobacteriota;Cyanophyceae;Synechococcales;Synechococcaceae;Synechococcus;Synechococcus sp. RS9909	0	1	0	0	1
Bacteria;Bacteria_none;Deferribacteres;Deferribacteres;Deferribacterales;Calditerrivibrionaceae;Calditerrivibrio;Calditerrivibrio nitroreducens	0	0	0	1	1
Bacteria;Bacteria_none;Deinococcota;Deinococci;Deinococcales;Deinococcaceae;Deinococcus;Deinococcus sp. QL22	0	0	0	1	1
Bacteria;Bacteria_none;Deinococcota;Deinococci;Thermales;Thermaceae;Thermus;Thermus thermophilus	0	0	0	1	1
Bacteria;Bacteria_none;Dictyoglomi;Dictyoglomia;Dictyoglomales;Dictyoglomaceae;Dictyoglomus;Dictyoglomus thermophilum	0	0	0	1	1
Bacteria;Bacteria_none;Fusobacteriota;Fusobacteriia;Fusobacteriales;Fusobacteriaceae;Fusobacterium;Fusobacterium gonidiaformans	0	0	0	1	1
Bacteria;Bacteria_none;Fusobacteriota;Fusobacteriia;Fusobacteriales;Fusobacteriaceae;Fusobacterium;Fusobacterium hominis	0	0	0	1	1
Bacteria;Bacteria_none;Fusobacteriota;Fusobacteriia;Fusobacteriales;Fusobacteriaceae;Fusobacterium;Fusobacterium mortiferum	0	0	0	1	1
Bacteria;Bacteria_none;Fusobacteriota;Fusobacteriia;Fusobacteriales;Fusobacteriaceae;Fusobacterium;Fusobacterium necrophorum	0	0	0	1	1
Bacteria;Bacteria_none;Fusobacteriota;Fusobacteriia;Fusobacteriales;Fusobacteriaceae;Fusobacterium;Fusobacterium ulcerans	1	0	0	0	1
Bacteria;Bacteria_none;Actinomycetota;Actinomycetes;Kitasatosporales;Streptomycetaceae;Streptomyces;Streptomyces prasinus	0	0	0	1	1
Bacteria;Bacteria_none;Fusobacteriota;Fusobacteriia;Fusobacteriales;Leptotrichiaceae;Leptotrichia;Leptotrichia shahii	1	0	0	0	1
Bacteria;Bacteria_none;Actinomycetota;Actinomycetes;Kitasatosporales;Streptomycetaceae;Streptomyces;Streptomyces sp. NA04227	0	1	0	0	1
Bacteria;Bacteria_none;Cyanobacteriota;Cyanophyceae;Nostocales;Nostocaceae;Nostoc;Nostoc sp. UHCC 0870	1	0	0	0	1
Bacteria;Bacteria_none;Cyanobacteriota;Cyanophyceae;Nostocales;Nostocaceae;Nostoc;Nostoc sp. MS1	1	0	0	0	1
Bacteria;Bacteria_none;Chloroflexota;Chloroflexia;Chloroflexales;Chloroflexaceae;Chloroflexus;Chloroflexus aggregans	0	0	1	0	1
Bacteria;Bacteria_none;Candidatus Cloacimonetes;Candidatus Cloacimonetes_Incertae_sedis;Candidatus Cloacimonetes_Incertae_sedis_Incertae_sedis;Candidatus Cloacimonetes_Incertae_sedis_Incertae_sedis_Incertae_sedis;Candidatus Cloacimonas;Candidatus Cloacimonas acidaminovorans	0	0	0	1	1
Bacteria;Bacteria_none;Candidatus Saccharibacteria;Candidatus Saccharimonadia;Candidatus Nanosynbacterales;Candidatus Nanosynbacteraceae;Candidatus Nanosynbacter;Candidatus Nanosynbacter lyticus	0	0	0	1	1
Bacteria;Bacteria_none;Chlamydiota;Chlamydiia;Chlamydiales;Chlamydiaceae;Chlamydia;Candidatus Chlamydia sanziniae	0	0	0	1	1
Bacteria;Bacteria_none;Chlamydiota;Chlamydiia;Chlamydiales;Chlamydiaceae;Chlamydia;Chlamydia poikilotherma	1	0	0	0	1
Bacteria;Bacteria_none;Actinomycetota;Actinomycetes;Kitasatosporales;Streptomycetaceae;Streptomyces;Streptomyces sp. S8	0	0	0	1	1
Bacteria;Bacteria_none;Chlamydiota;Chlamydiia;Chlamydiales;Chlamydiaceae;Chlamydiifrater;Chlamydiifrater phoenicopteri	1	0	0	0	1
Bacteria;Bacteria_none;Chlorobiota;Chlorobiia;Chlorobiales;Chloroherpetonaceae;Chloroherpeton;Chloroherpeton thalassium	0	0	0	1	1
Bacteria;Bacteria_none;Chloroflexota;Anaerolineae;Anaerolineales;Anaerolineaceae;Anaerolinea;Anaerolinea thermophila	0	0	0	1	1
Bacteria;Bacteria_none;Cyanobacteriota;Cyanobacteriota_Incertae_sedis;Cyanobacteriota_Incertae_sedis_Incertae_sedis;Cyanobacteriota_Incertae_sedis_Incertae_sedis_Incertae_sedis;Cyanobacteriota_Incertae_sedis_Incertae_sedis_Incertae_sedis_Incertae_sedis;cyanobacterium endosymbiont of Rhopalodia gibberula	0	0	1	0	1
Bacteria;Bacteria_none;Cyanobacteriota;Cyanophyceae;Nostocales;Nostocaceae;Nostoc;Nostoc sp. C052	0	1	0	0	1
Bacteria;Bacteria_none;Cyanobacteriota;Cyanophyceae;Chroococcales;Geminocystaceae;Cyanobacterium;Cyanobacterium sp. uoEpiScrs1	0	0	0	1	1
Bacteria;Bacteria_none;Cyanobacteriota;Cyanophyceae;Gloeomargaritales;Gloeomargaritaceae;Gloeomargarita;Gloeomargarita lithophora	0	0	0	1	1
Bacteria;Bacteria_none;Actinomycetota;Actinomycetes;Kitasatosporales;Streptomycetaceae;Streptomyces;Streptomyces sp. NHF165	1	0	0	0	1
Bacteria;Bacteria_none;Cyanobacteriota;Cyanophyceae;Nostocales;Aphanizomenonaceae;Nodularia;Nodularia sphaerocarpa	0	0	0	1	1
Bacteria;Bacteria_none;Cyanobacteriota;Cyanophyceae;Nostocales;Calotrichaceae;Calothrix;Calothrix parasitica	0	0	0	1	1
Bacteria;Bacteria_none;Cyanobacteriota;Cyanophyceae;Nostocales;Calotrichaceae;Calothrix;Calothrix sp. NIES-3974	0	1	0	0	1
Bacteria;Bacteria_none;Cyanobacteriota;Cyanophyceae;Nostocales;Nostocaceae;Nostoc;Nostoc linckia	0	0	0	1	1
Bacteria;Bacteria_none;Cyanobacteriota;Cyanophyceae;Nostocales;Nostocaceae;Nostoc;Nostoc sp. ATCC 53789	0	1	0	0	1
Bacteria;Bacteria_none;Bacteroidota;Flavobacteriia;Flavobacteriales;Flavobacteriaceae;Flavobacterium;Flavobacterium cerinum	1	0	0	0	1
Bacteria;Bacteria_none;Bacteroidota;Flavobacteriia;Flavobacteriales;Flavobacteriaceae;Cellulophaga;Cellulophaga omnivescoria	0	0	1	0	1
Bacteria;Bacteria_none;Bacillota;Erysipelotrichia;Erysipelotrichales;Erysipelotrichaceae;Longicatena;Longicatena caecimuris	0	0	0	1	1
Bacteria;Bacteria_none;Actinomycetota;Actinomycetes;Micrococcales;Microbacteriaceae;Microbacterium;Microbacterium sp. SSW1-36	0	0	1	0	1
Bacteria;Bacteria_none;Bacteroidota;Bacteroidia;Bacteroidales;Muribaculaceae;Sodaliphilus;Sodaliphilus pleomorphus	0	0	0	1	1
Bacteria;Bacteria_none;Bacteroidota;Bacteroidia;Bacteroidales;Odoribacteraceae;Odoribacter;Odoribacter splanchnicus	0	0	0	1	1
Bacteria;Bacteria_none;Actinomycetota;Actinomycetes;Mycobacteriales;Corynebacteriaceae;Corynebacterium;Corynebacterium accolens	0	0	1	0	1
Bacteria;Bacteria_none;Bacteroidota;Bacteroidia;Bacteroidales;Porphyromonadaceae;Porphyromonas;Porphyromonas crevioricanis	0	0	0	1	1
Bacteria;Bacteria_none;Bacteroidota;Bacteroidia;Bacteroidales;Porphyromonadaceae;Porphyromonas;Porphyromonas endodontalis	0	0	0	1	1
Bacteria;Bacteria_none;Actinomycetota;Actinomycetes;Micromonosporales;Micromonosporaceae;Phytohabitans;Phytohabitans flavus	0	0	1	0	1
Bacteria;Bacteria_none;Actinomycetota;Actinomycetes;Micromonosporales;Micromonosporaceae;Micromonospora;Micromonospora viridifaciens	0	0	0	1	1
Bacteria;Bacteria_none;Actinomycetota;Actinomycetes;Micromonosporales;Micromonosporaceae;Micromonospora;Micromonospora purpureochromogenes	0	0	0	1	1
Bacteria;Bacteria_none;Actinomycetota;Actinomycetes;Micromonosporales;Micromonosporaceae;Actinoplanes;Actinoplanes sp. L3-i22	0	0	0	1	1
Bacteria;Bacteria_none;Bacteroidota;Bacteroidia;Bacteroidales;Prevotellaceae;Paraprevotella;Paraprevotella xylaniphila	0	0	0	1	1
Bacteria;Bacteria_none;Actinomycetota;Actinomycetes;Micrococcales;Promicromonosporaceae;Isoptericola;Isoptericola dokdonensis	0	0	1	0	1
Bacteria;Bacteria_none;Actinomycetota;Actinomycetes;Micrococcales;Ornithinimicrobiaceae;Serinicoccus;Serinicoccus hydrothermalis	0	1	0	0	1
Bacteria;Bacteria_none;Actinomycetota;Actinomycetes;Micrococcales;Micrococcaceae;Rothia;Rothia dentocariosa	1	0	0	0	1
Bacteria;Bacteria_none;Actinomycetota;Actinomycetes;Micrococcales;Micrococcaceae;Rothia;Rothia aeria	0	1	0	0	1
Bacteria;Bacteria_none;Actinomycetota;Actinomycetes;Micrococcales;Micrococcaceae;Psychromicrobium;Psychromicrobium lacuslunae	0	1	0	0	1
Bacteria;Bacteria_none;Actinomycetota;Actinomycetes;Micrococcales;Micrococcaceae;Kocuria;Kocuria varians	0	0	0	1	1
Bacteria;Bacteria_none;Actinomycetota;Actinomycetes;Micrococcales;Micrococcaceae;Glutamicibacter;Glutamicibacter creatinolyticus	0	0	0	1	1
Bacteria;Bacteria_none;Actinomycetota;Actinomycetes;Micrococcales;Micrococcaceae;Arthrobacter;Arthrobacter sp. YA7-1	0	0	0	1	1
Bacteria;Bacteria_none;Actinomycetota;Actinomycetes;Micrococcales;Micrococcaceae;Arthrobacter;Arthrobacter sp. KBS0702	0	0	1	0	1
Bacteria;Bacteria_none;Bacteroidota;Bacteroidia;Bacteroidales;Dysgonomonadaceae;Proteiniphilum;Proteiniphilum propionicum	0	0	0	1	1
Bacteria;Bacteria_none;Bacteroidota;Bacteroidia;Bacteroidales;Bacteroidaceae;Phocaeicola;Phocaeicola salanitronis	0	0	0	1	1
Bacteria;Bacteria_none;Actinomycetota;Actinomycetes;Mycobacteriales;Corynebacteriaceae;Corynebacterium;Corynebacterium efficiens	0	0	0	1	1
Bacteria;Bacteria_none;Actinomycetota;Actinomycetes;Mycobacteriales;Gordoniaceae;Skermania;Skermania piniformis	1	0	0	0	1
Bacteria;Bacteria_none;Bacillota;Negativicutes;Acidaminococcales;Acidaminococcaceae;Phascolarctobacterium;Phascolarctobacterium faecium	0	0	0	1	1
Bacteria;Bacteria_none;Actinomycetota;Actinomycetes;Mycobacteriales;Mycobacteriaceae;Mycobacterium;Mycobacterium intracellulare	0	0	0	1	1
Bacteria;Bacteria_none;Actinomycetota;Actinomycetes;Mycobacteriales;Mycobacteriaceae;Mycobacterium;Mycobacterium heraklionense	0	1	0	0	1
Bacteria;Bacteria_none;Actinomycetota;Actinomycetes;Mycobacteriales;Mycobacteriaceae;Mycobacterium;Mycobacterium heidelbergense	0	1	0	0	1
Bacteria;Bacteria_none;Bacillota;Negativicutes;Veillonellales;Veillonellaceae;Megasphaera;Megasphaera massiliensis	0	0	0	1	1
Bacteria;Bacteria_none;Actinomycetota;Actinomycetes;Mycobacteriales;Mycobacteriaceae;Mycobacterium;Mycobacterium colombiense	1	0	0	0	1
Bacteria;Bacteria_none;Actinomycetota;Actinomycetes;Mycobacteriales;Mycobacteriaceae;Mycobacterium;Mycobacterium branderi	0	1	0	0	1
Bacteria;Bacteria_none;Bacillota;Negativicutes;Veillonellales;Veillonellaceae;Veillonella;Veillonella dispar	0	0	1	0	1
Bacteria;Bacteria_none;Actinomycetota;Actinomycetes;Mycobacteriales;Gordoniaceae;Gordonia;Gordonia rubripertincta	0	1	0	0	1
Bacteria;Bacteria_none;Bacteroidota;Bacteroidia;Bacteroidales;Bacteroidaceae;Bacteroides;Bacteroides sp. M10	0	0	0	1	1
Bacteria;Bacteria_none;Actinomycetota;Actinomycetes;Mycobacteriales;Corynebacteriaceae;Corynebacterium;Corynebacterium singulare	0	0	0	1	1
Bacteria;Bacteria_none;Bacillota;Tissierellia;Tissierellales;Peptoniphilaceae;Murdochiella;Murdochiella vaginalis	0	0	0	1	1
Bacteria;Bacteria_none;Actinomycetota;Actinomycetes;Mycobacteriales;Corynebacteriaceae;Corynebacterium;Corynebacterium resistens	1	0	0	0	1
Bacteria;Bacteria_none;Bacillota;Tissierellia;Tissierellales;Peptoniphilaceae;Peptoniphilus;Peptoniphilus sp. CBA3646	0	0	0	1	1
Bacteria;Bacteria_none;Actinomycetota;Actinomycetes;Mycobacteriales;Corynebacteriaceae;Corynebacterium;Corynebacterium liangguodongii	0	0	0	1	1
Bacteria;Bacteria_none;Bacteroidota;Bacteroidia;Bacteroidales;Bacteroidaceae;Bacteroides;Bacteroides faecis	0	0	0	1	1
Bacteria;Bacteria_none;Actinomycetota;Actinomycetes;Mycobacteriales;Corynebacteriaceae;Corynebacterium;Corynebacterium genitalium	1	0	0	0	1
Bacteria;Bacteria_none;Actinomycetota;Actinomycetes;Mycobacteriales;Corynebacteriaceae;Corynebacterium;Corynebacterium freneyi	0	0	1	0	1
Bacteria;Bacteria_none;Actinomycetota;Actinomycetes;Micrococcales;Microbacteriaceae;Rathayibacter;Rathayibacter tanaceti	0	1	0	0	1
Bacteria;Bacteria_none;Actinomycetota;Actinomycetes;Micrococcales;Microbacteriaceae;Microbacterium;Microbacterium cremeum	0	0	1	0	1
Bacteria;Bacteria_none;Bacteroidota;Flavobacteriia;Flavobacteriales;Flavobacteriaceae;Capnocytophaga;Capnocytophaga stomatis	0	0	0	1	1
Bacteria;Bacteria_none;Actinomycetota;Actinomycetes;Micrococcales;Microbacteriaceae;Microbacterium;Microbacterium azadirachtae	0	0	0	1	1
Bacteria;Bacteria_none;Bacteroidota;Cytophagia;Cytophagales;Cyclobacteriaceae;Echinicola;Echinicola strongylocentroti	0	1	0	0	1
Bacteria;Bacteria_none;Bacteroidota;Cytophagia;Cytophagales;Cytophagaceae;Spirosoma;Spirosoma endbachense	1	0	0	0	1
Bacteria;Bacteria_none;Bacteroidota;Cytophagia;Cytophagales;Fulvivirgaceae;Chryseolinea;Chryseolinea soli	1	0	0	0	1
Bacteria;Bacteria_none;Bacteroidota;Cytophagia;Cytophagales;Fulvivirgaceae;Fulvivirga;Fulvivirga sp. SS9-22	0	0	0	1	1
Bacteria;Bacteria_none;Bacteroidota;Cytophagia;Cytophagales;Fulvivirgaceae;Fulvivirga;Fulvivirga sp. W9P-11	1	0	0	0	1
Bacteria;Bacteria_none;Bacteroidota;Cytophagia;Cytophagales;Hymenobacteraceae;Adhaeribacter;Adhaeribacter swui	0	0	0	1	1
Bacteria;Bacteria_none;Bacteroidota;Cytophagia;Cytophagales;Hymenobacteraceae;Hymenobacter;Hymenobacter sp. PAMC 26628	1	0	0	0	1
Bacteria;Bacteria_none;Actinomycetota;Actinomycetes;Micrococcales;Dermabacteraceae;Dermabacter;Dermabacter vaginalis	0	0	0	1	1
Bacteria;Bacteria_none;Bacteroidota;Cytophagia;Cytophagales;Hymenobacteraceae;Rufibacter;Rufibacter tibetensis	0	1	0	0	1
Bacteria;Bacteria_none;Bacteroidota;Cytophagia;Cytophagales;Mangrovivirgaceae;Mangrovivirga;Mangrovivirga cuniculi	0	0	0	1	1
Bacteria;Bacteria_none;Bacteroidota;Cytophagia;Cytophagales;Spirosomaceae;Dyadobacter;Dyadobacter sp. CY22	0	1	0	0	1
Bacteria;Bacteria_none;Bacteroidota;Cytophagia;Cytophagales;Spirosomaceae;Dyadobacter;Dyadobacter sp. U1	0	1	0	0	1
Bacteria;Bacteria_none;Bacteroidota;Cytophagia;Cytophagales;Spirosomaceae;Emticicia;Emticicia sp. 21SJ11W-3	0	0	0	1	1
Bacteria;Bacteria_none;Bacteroidota;Flavobacteriia;Flavobacteriales;Blattabacteriaceae;Blattabacterium;Blattabacterium sp. (Nauphoeta cinerea)	0	0	0	1	1
Bacteria;Bacteria_none;Bacteroidota;Flavobacteriia;Flavobacteriales;Flavobacteriaceae;Aequorivita;Aequorivita sublithincola	0	0	0	1	1
Bacteria;Bacteria_none;Bacteroidota;Flavobacteriia;Flavobacteriales;Flavobacteriaceae;Antarcticibacterium;Antarcticibacterium sp. 1MA-6-2	0	0	0	1	1
Bacteria;Bacteria_none;Bacteroidota;Flavobacteriia;Flavobacteriales;Flavobacteriaceae;Aquimarina;Aquimarina sp. Aq107	0	1	0	0	1
Bacteria;Bacteria_none;Bacteroidota;Flavobacteriia;Flavobacteriales;Flavobacteriaceae;Aquimarina;Aquimarina sp. BL5	0	0	0	1	1
Bacteria;Bacteria_none;Bacteroidota;Flavobacteriia;Flavobacteriales;Flavobacteriaceae;Arenibacter;Arenibacter algicola	0	0	0	1	1
Bacteria;Bacteria_none;Bacteroidota;Cytophagia;Cytophagales;Cyclobacteriaceae;Algoriphagus;Algoriphagus sanaruensis	0	0	0	1	1
Bacteria;Bacteria_none;Bacteroidota;Chitinophagia;Chitinophagales;Chitinophagaceae;Panacibacter;Panacibacter ginsenosidivorans	0	0	1	0	1
Bacteria;Bacteria_none;Bacteroidota;Chitinophagia;Chitinophagales;Chitinophagaceae;Niastella;Niastella koreensis	0	0	0	1	1
Bacteria;Bacteria_none;Actinomycetota;Actinomycetes;Micrococcales;Intrasporangiaceae;Janibacter;Janibacter indicus	0	1	0	0	1
Bacteria;Bacteria_none;Actinomycetota;Actinomycetes;Micrococcales;Microbacteriaceae;Herbiconiux;Herbiconiux sp. L3-i23	0	0	1	0	1
Bacteria;Bacteria_none;Actinomycetota;Actinomycetes;Micrococcales;Microbacteriaceae;Frigoribacterium;Frigoribacterium sp. SL97	1	0	0	0	1
Bacteria;Bacteria_none;Bacteroidota;Bacteroidia;Bacteroidales;Prevotellaceae;Prevotella;Prevotella sp. E15-22	0	0	0	1	1
Bacteria;Bacteria_none;Actinomycetota;Actinomycetes;Micrococcales;Microbacteriaceae;Curtobacterium;Curtobacterium sp. L6-1	0	1	0	0	1
Bacteria;Bacteria_none;Bacteroidota;Bacteroidia;Bacteroidales;Prevotellaceae;Prevotella;Prevotella sp. E9-3	0	0	0	1	1
Bacteria;Bacteria_none;Actinomycetota;Actinomycetes;Micrococcales;Microbacteriaceae;Cryobacterium;Cryobacterium sp. SO1	0	0	0	1	1
Bacteria;Bacteria_none;Actinomycetota;Actinomycetes;Micrococcales;Microbacteriaceae;Agromyces;Agromyces sp. CFWR-12	0	1	0	0	1
Bacteria;Bacteria_none;Actinomycetota;Actinomycetes;Micrococcales;Microbacteriaceae;Agrococcus;Agrococcus sp. SCSIO52902	0	1	0	0	1
Bacteria;Bacteria_none;Actinomycetota;Actinomycetes;Micrococcales;Dermacoccaceae;Dermacoccus;Dermacoccus nishinomiyaensis	1	0	0	0	1
Bacteria;Bacteria_none;Bacteroidota;Chitinophagia;Chitinophagales;Chitinophagaceae;Ferruginibacter;Ferruginibacter lapsinanis	0	0	0	1	1
Bacteria;Bacteria_none;Actinomycetota;Actinomycetes;Micrococcales;Dermabacteraceae;Devriesea;Devriesea agamarum	0	1	0	0	1
Archaea;Archaea_none;Crenarchaeota;Thermoprotei;Desulfurococcales;Desulfurococcaceae;Desulfurococcus;Desulfurococcus amylolyticus	0	0	0	1	1
Bacteria;Bacteria_none;Bacteroidota;Bacteroidia;Bacteroidales;Tannerellaceae;Parabacteroides;Parabacteroides merdae	0	0	0	1	1
Bacteria;Bacteria_none;Bacteroidota;Bacteroidia;Bacteroidales;Tannerellaceae;Tannerella;Tannerella serpentiformis	0	0	0	1	1
Bacteria;Bacteria_none;Bacteroidota;Bacteroidia;Marinilabiliales;Marinifilaceae;Labilibaculum;Labilibaculum antarcticum	0	1	0	0	1
Bacteria;Bacteria_none;Bacteroidota;Bacteroidota_Incertae_sedis;Bacteroidota_Incertae_sedis_Incertae_sedis;Rhodothermaceae;Rhodothermus;Rhodothermus marinus	0	0	1	0	1
Bacteria;Bacteria_none;Bacteroidota;Bacteroidota_Incertae_sedis;Candidatus Sulfidibacteriales;Candidatus Sulfidibacteriales_Incertae_sedis;Candidatus Sulfidibacterium;Candidatus Sulfidibacterium hydrothermale	0	0	0	1	1
Bacteria;Bacteria_none;Bacteroidota;Chitinophagia;Chitinophagales;Chitinophagaceae;Arachidicoccus;Arachidicoccus soli	0	0	0	1	1
Bacteria;Bacteria_none;Bacteroidota;Bacteroidia;Bacteroidales;Tannerellaceae;Parabacteroides;Parabacteroides faecis	0	0	0	1	1
