tax	ENRbarcode1	ENRbarcode2	ENRbarcode3	ENRbarcode4	NORMbarcode1	NORMbarcode2	NORMbarcode3	NORMbarcode4	total
Eukaryota;Metazoa;Chordata;Mammalia;Primates;Hominidae;Homo;Homo sapiens	468656	786213	630085	833056	938991	1568742	1265960	1734720	8226423
Bacteria;Bacteria_none;Bacillota;Bacilli;Lactobacillales;Lactobacillaceae;Lactobacillus;Lactobacillus crispatus	13	26755	143	6	18	54338	278	14	81565
Bacteria;Bacteria_none;Bacillota;Bacilli;Lactobacillales;Lactobacillaceae;Lactobacillus;Lactobacillus iners	1767	115	1085	122	3711	226	2263	257	9546
Bacteria;Bacteria_none;Actinomycetota;Actinomycetes;Bifidobacteriales;Bifidobacteriaceae;Gardnerella;Gardnerella vaginalis	39	20	398	1573	91	42	820	3749	6732
Bacteria;Bacteria_none;Actinomycetota;Actinomycetes;Bifidobacteriales;Bifidobacteriaceae;Gardnerella;Gardnerella leopoldii	12	1	103	1155	27	1	165	2343	3807
Bacteria;Bacteria_none;Fusobacteriota;Fusobacteriia;Fusobacteriales;Leptotrichiaceae;Sneathia;Sneathia vaginalis	0	1	1	618	0	0	0	1314	1934
Bacteria;Bacteria_none;Actinomycetota;Actinomycetes;Bifidobacteriales;Bifidobacteriaceae;Gardnerella;Gardnerella piotii	8	5	138	256	27	5	342	536	1317
Bacteria;Bacteria_none;Actinomycetota;Actinomycetes;Bifidobacteriales;Bifidobacteriaceae;Gardnerella;Gardnerella swidsinskii	0	0	4	407	9	0	7	758	1185
Bacteria;Bacteria_none;Bacillota;Bacilli;Lactobacillales;Lactobacillaceae;Lactobacillus;Lactobacillus jensenii	173	181	0	0	373	386	1	1	1115
Bacteria;Bacteria_none;Bacteroidota;Bacteroidia;Bacteroidales;Prevotellaceae;Hoylesella;Hoylesella buccalis	1	0	0	334	2	1	1	724	1063
Bacteria;Bacteria_none;Actinomycetota;Actinomycetes;Actinomycetales;Actinomycetaceae;Fannyhessea;Fannyhessea vaginae	1	0	0	243	0	0	0	467	711
Bacteria;Bacteria_none;Mycoplasmatota;Mycoplasmatota_Incertae_sedis;Mycoplasmoidales;Metamycoplasmataceae;Metamycoplasma;Metamycoplasma hominis	0	0	0	225	0	0	0	449	674
Bacteria;Bacteria_none;Bacteroidota;Bacteroidia;Bacteroidales;Prevotellaceae;Prevotella;Prevotella corporis	1	0	0	176	2	0	2	405	586
Bacteria;Bacteria_none;Chlamydiota;Chlamydiia;Chlamydiales;Chlamydiaceae;Chlamydia;Chlamydia trachomatis	0	0	182	0	0	0	321	0	503
Bacteria;Bacteria_none;Bacteroidota;Bacteroidia;Bacteroidales;Prevotellaceae;Prevotella;Prevotella melaninogenica	3	0	0	109	5	0	0	330	447
Bacteria;Bacteria_none;Bacillota;Bacilli;Lactobacillales;Lactobacillaceae;Limosilactobacillus;Limosilactobacillus portuensis	0	119	1	0	0	300	2	0	422
Bacteria;Bacteria_none;Actinomycetota;Actinomycetes;Propionibacteriales;Propionibacteriaceae;Cutibacterium;Cutibacterium acnes	39	28	45	4	92	69	75	15	367
Bacteria;Bacteria_none;Bacteroidota;Bacteroidia;Bacteroidales;Prevotellaceae;Prevotella;Prevotella intermedia	0	0	0	92	5	1	0	180	278
Eukaryota;Fungi;Ascomycota;Saccharomycetes;Saccharomycetales;Debaryomycetaceae;Candida;Candida albicans	4	63	2	0	7	158	0	0	234
Bacteria;Bacteria_none;Bacillota;Bacilli;Lactobacillales;Lactobacillaceae;Lactobacillus;Lactobacillus helveticus	0	68	0	0	1	146	1	0	216
Bacteria;Bacteria_none;Bacillota;Bacilli;Bacillales;Staphylococcaceae;Staphylococcus;Staphylococcus aureus	37	1	25	3	89	15	38	6	214
Bacteria;Bacteria_none;Bacillota;Clostridia;Eubacteriales;Oscillospiraceae;Mageeibacillus;Mageeibacillus indolicus	0	1	0	76	1	0	0	135	213
Bacteria;Bacteria_none;Bacillota;Bacilli;Lactobacillales;Lactobacillaceae;Lactobacillus;Lactobacillus amylovorus	0	37	0	0	0	157	2	0	196
Bacteria;Bacteria_none;Bacteroidota;Bacteroidia;Bacteroidales;Prevotellaceae;Prevotella;Prevotella nigrescens	0	1	0	66	0	0	0	129	196
Bacteria;Bacteria_none;Bacteroidota;Bacteroidia;Bacteroidales;Prevotellaceae;Prevotella;Prevotella jejuni	0	0	0	57	4	0	0	130	191
Bacteria;Bacteria_none;Mycoplasmatota;Mollicutes;Mycoplasmatales;Mycoplasmataceae;Ureaplasma;Ureaplasma parvum	0	35	2	5	0	69	8	20	139
Bacteria;Bacteria_none;Bacteroidota;Bacteroidia;Bacteroidales;Prevotellaceae;Prevotella;Prevotella multiformis	0	0	0	34	0	0	0	99	133
Bacteria;Bacteria_none;Bacteroidota;Bacteroidia;Bacteroidales;Porphyromonadaceae;Porphyromonas;Porphyromonas somerae	1	0	0	40	0	0	0	64	105
Bacteria;Bacteria_none;Pseudomonadota;Gammaproteobacteria;Enterobacterales;Enterobacteriaceae;Escherichia;Escherichia coli	0	3	6	0	26	34	20	10	99
Bacteria;Bacteria_none;Bacteroidota;Bacteroidia;Bacteroidales;Prevotellaceae;Prevotella;Prevotella denticola	0	0	0	26	1	0	0	67	94
Bacteria;Bacteria_none;Bacteroidota;Bacteroidia;Bacteroidales;Prevotellaceae;Prevotella;Prevotella histicola	0	0	0	23	1	0	0	65	89
Bacteria;Bacteria_none;Bacillota;Tissierellia;Tissierellales;Peptoniphilaceae;Peptoniphilus;Peptoniphilus sp. SAHP1	5	2	0	32	3	2	0	44	88
Bacteria;Bacteria_none;Pseudomonadota;Gammaproteobacteria;Enterobacterales;Enterobacteriaceae;Enterobacter;Enterobacter hormaechei	6	10	2	7	9	23	5	20	82
Bacteria;Bacteria_none;Bacteroidota;Bacteroidia;Bacteroidales;Prevotellaceae;Prevotella;Prevotella scopos	0	0	0	23	0	0	0	51	74
Bacteria;Bacteria_none;Bacillota;Bacilli;Lactobacillales;Aerococcaceae;Aerococcus;Aerococcus christensenii	5	0	0	11	19	0	0	36	71
Bacteria;Bacteria_none;Bacteroidota;Bacteroidia;Bacteroidales;Prevotellaceae;Prevotella;Prevotella veroralis	1	0	0	15	0	0	0	50	66
Bacteria;Bacteria_none;Bacteroidota;Bacteroidia;Bacteroidales;Prevotellaceae;Prevotella;Prevotella fusca	0	0	0	20	0	0	0	33	53
Bacteria;Bacteria_none;Bacteroidota;Bacteroidia;Bacteroidales;Prevotellaceae;Hoylesella;Hoylesella enoeca	0	0	0	14	0	0	0	39	53
Bacteria;Bacteria_none;Actinomycetota;Coriobacteriia;Eggerthellales;Eggerthellaceae;Gordonibacter;Gordonibacter pamelaeae	0	0	0	9	0	0	0	42	51
Bacteria;Bacteria_none;Bacteroidota;Bacteroidia;Bacteroidales;Prevotellaceae;Prevotella;Prevotella copri	0	0	0	17	2	0	0	31	50
Bacteria;Bacteria_none;Bacillota;Bacilli;Bacillales;Paenibacillaceae;Paenibacillus;Paenibacillus larvae	0	0	0	0	0	0	0	49	49
Bacteria;Bacteria_none;Bacteroidota;Bacteroidia;Bacteroidales;Prevotellaceae;Prevotella;Prevotella sp. oral taxon 299	0	0	0	10	0	1	0	35	46
Bacteria;Bacteria_none;Bacteroidota;Bacteroidia;Bacteroidales;Prevotellaceae;Prevotella;Prevotella sp. oral taxon 313	0	0	0	15	0	0	0	28	43
Bacteria;Bacteria_none;Bacteroidota;Bacteroidia;Bacteroidales;Prevotellaceae;Prevotella;Prevotella bryantii	1	0	0	9	3	0	1	27	41
Bacteria;Bacteria_none;Bacillota;Bacilli;Bacillales;Staphylococcaceae;Staphylococcus;Staphylococcus epidermidis	2	6	1	2	11	4	12	1	39
Bacteria;Bacteria_none;Bacillota;Bacilli;Lactobacillales;Lactobacillaceae;Limosilactobacillus;Limosilactobacillus vaginalis	0	14	0	0	0	25	0	0	39
Bacteria;Bacteria_none;Pseudomonadota;Gammaproteobacteria;Moraxellales;Moraxellaceae;Moraxella;Moraxella osloensis	0	1	7	0	3	16	11	0	38
Viruses;Heunggongvirae;Uroviricota;Caudoviricetes;Caudoviricetes_Incertae_sedis;Caudoviricetes_Incertae_sedis_Incertae_sedis;Caudoviricetes_Incertae_sedis_Incertae_sedis_Incertae_sedis;Lactobacillus phage Lv-1	7	7	0	0	16	8	0	0	38
Bacteria;Bacteria_none;Bacillota;Tissierellia;Tissierellales;Peptoniphilaceae;Finegoldia;Finegoldia magna	2	4	1	2	8	4	6	9	36
Bacteria;Bacteria_none;Bacillota;Tissierellia;Tissierellales;Peptoniphilaceae;Parvimonas;Parvimonas micra	1	0	0	1	0	0	0	32	34
Bacteria;Bacteria_none;Pseudomonadota;Gammaproteobacteria;Pasteurellales;Pasteurellaceae;Haemophilus;Haemophilus parainfluenzae	8	0	0	0	20	1	1	3	33
Bacteria;Bacteria_none;Bacteroidota;Bacteroidia;Bacteroidales;Porphyromonadaceae;Porphyromonas;Porphyromonas gingivalis	0	0	0	12	0	0	0	20	32
Bacteria;Bacteria_none;Bacillota;Negativicutes;Veillonellales;Veillonellaceae;Dialister;Dialister succinatiphilus	0	0	0	8	0	0	0	23	31
Bacteria;Bacteria_none;Bacillota;Bacilli;Lactobacillales;Streptococcaceae;Streptococcus;Streptococcus anginosus	4	0	1	6	4	2	0	14	31
Bacteria;Bacteria_none;Bacillota;Bacilli;Lactobacillales;Streptococcaceae;Streptococcus;Streptococcus sp. 'group B'	12	0	0	17	0	0	0	0	29
Eukaryota;Fungi;Basidiomycota;Malasseziomycetes;Malasseziales;Malasseziaceae;Malassezia;Malassezia restricta	0	4	6	2	4	8	3	0	27
Bacteria;Bacteria_none;Bacillota;Tissierellia;Tissierellales;Peptoniphilaceae;Peptoniphilus;Peptoniphilus harei	0	0	1	4	0	1	0	20	26
Bacteria;Bacteria_none;Bacillota;Bacilli;Lactobacillales;Lactobacillaceae;Lactiplantibacillus;Lactiplantibacillus plantarum	0	11	0	0	0	14	0	0	25
Unclassified;Unknown;Unknown;Unknown;Unknown;Unknown;Unknown;Unknown	1	3	1	2	8	5	1	1	22
Bacteria;Bacteria_none;Actinomycetota;Actinomycetes;Micrococcales;Micrococcaceae;Micrococcus;Micrococcus luteus	0	0	0	0	7	9	6	0	22
Bacteria;Bacteria_none;Bacteroidota;Bacteroidia;Bacteroidales;Prevotellaceae;Prevotella;Prevotella herbatica	0	0	0	4	1	0	0	16	21
Bacteria;Bacteria_none;Bacillota;Bacilli;Lactobacillales;Streptococcaceae;Streptococcus;Streptococcus sp. oral taxon 431	0	0	3	0	1	1	15	1	21
Bacteria;Bacteria_none;Bacillota;Bacilli;Lactobacillales;Streptococcaceae;Streptococcus;Streptococcus agalactiae	0	0	0	2	0	0	0	18	20
Bacteria;Bacteria_none;Synergistota;Synergistia;Synergistales;Aminobacteriaceae;Aminobacterium;Aminobacterium colombiense	0	3	0	0	0	17	0	0	20
Bacteria;Bacteria_none;Bacteroidota;Bacteroidia;Bacteroidales;Prevotellaceae;Prevotella;Prevotella oris	1	0	0	1	0	0	1	17	20
Bacteria;Bacteria_none;Actinomycetota;Actinomycetes;Actinomycetales;Actinomycetaceae;Schaalia;Schaalia turicensis	0	0	0	9	0	0	0	11	20
Bacteria;Bacteria_none;Bacillota;Bacilli;Lactobacillales;Streptococcaceae;Streptococcus;Streptococcus mitis	3	3	0	0	8	1	2	2	19
Eukaryota;Eukaryota_Incertae_sedis;Apicomplexa;Conoidasida;Eucoccidiorida;Sarcocystidae;Toxoplasma;Toxoplasma gondii	2	1	3	3	0	4	2	3	18
Bacteria;Bacteria_none;Bacteroidota;Bacteroidia;Bacteroidales;Bacteroidaceae;Bacteroides;Bacteroides ovatus	0	0	0	3	0	0	0	14	17
Bacteria;Bacteria_none;Bacillota;Bacilli;Bacillales;Staphylococcaceae;Staphylococcus;Staphylococcus capitis	0	2	2	0	6	2	4	1	17
Bacteria;Bacteria_none;Bacillota;Negativicutes;Veillonellales;Veillonellaceae;Dialister;Dialister pneumosintes	0	0	0	2	0	0	0	15	17
Bacteria;Bacteria_none;Actinomycetota;Coriobacteriia;Eggerthellales;Eggerthellaceae;Berryella;Berryella wangjianweii	0	0	0	6	0	0	0	11	17
Bacteria;Bacteria_none;Bacillota;Bacilli;Lactobacillales;Streptococcaceae;Streptococcus;Streptococcus pneumoniae	0	0	0	0	1	3	0	12	16
Bacteria;Bacteria_none;Bacillota;Bacilli;Lactobacillales;Enterococcaceae;Enterococcus;Enterococcus mundtii	0	4	0	0	0	12	0	0	16
Bacteria;Bacteria_none;Pseudomonadota;Gammaproteobacteria;Pseudomonadales;Pseudomonadaceae;Pseudomonas;Pseudomonas putida	0	1	0	4	1	0	2	8	16
Bacteria;Bacteria_none;Bacteroidota;Bacteroidia;Bacteroidales;Prevotellaceae;Prevotella;Prevotella dentalis	0	0	0	2	0	0	0	14	16
Bacteria;Bacteria_none;Actinomycetota;Actinomycetes;Micrococcales;Micrococcaceae;Rothia;Rothia mucilaginosa	2	0	0	2	5	0	1	5	15
Bacteria;Bacteria_none;Bacillota;Bacilli;Lactobacillales;Lactobacillaceae;Limosilactobacillus;Limosilactobacillus reuteri	0	5	0	0	0	9	1	0	15
Bacteria;Bacteria_none;Bacillota;Bacilli;Lactobacillales;Lactobacillaceae;Lactobacillus;Lactobacillus kefiranofaciens	0	2	0	0	0	13	0	0	15
Eukaryota;Fungi;Basidiomycota;Pucciniomycetes;Pucciniales;Pucciniaceae;Puccinia;Puccinia striiformis	0	1	1	1	0	2	1	8	14
Bacteria;Bacteria_none;Bacillota;Bacilli;Lactobacillales;Lactobacillaceae;Lactobacillus;Lactobacillus gasseri	0	4	0	0	1	8	0	0	13
Bacteria;Bacteria_none;Actinomycetota;Actinomycetes;Mycobacteriales;Corynebacteriaceae;Corynebacterium;Corynebacterium tuberculostearicum	0	0	1	0	9	0	3	0	13
Bacteria;Bacteria_none;Bacillota;Bacilli;Lactobacillales;Streptococcaceae;Streptococcus;Streptococcus oralis	5	0	1	0	1	3	3	0	13
Bacteria;Bacteria_none;Bacillota;Bacilli;Lactobacillales;Lactobacillaceae;Lactobacillus;Lactobacillus amylolyticus	0	4	0	0	0	7	1	0	12
Bacteria;Bacteria_none;Bacillota;Bacilli;Lactobacillales;Lactobacillaceae;Lactobacillus;Lactobacillus johnsonii	0	5	0	0	0	7	0	0	12
Bacteria;Bacteria_none;Actinomycetota;Actinomycetes;Micrococcales;Micrococcaceae;Kocuria;Kocuria rhizophila	0	0	5	0	2	0	5	0	12
Bacteria;Bacteria_none;Bacteroidota;Bacteroidia;Bacteroidales;Bacteroidaceae;Bacteroides;Bacteroides fragilis	0	1	0	7	0	0	0	3	11
Bacteria;Bacteria_none;Bacillota;Tissierellia;Tissierellales;Peptoniphilaceae;Anaerococcus;Anaerococcus mediterraneensis	0	0	0	1	1	0	0	9	11
Bacteria;Bacteria_none;Actinomycetota;Actinomycetes;Actinomycetales;Actinomycetaceae;Winkia;Winkia neuii	3	1	1	0	2	0	4	0	11
Bacteria;Bacteria_none;Bacillota;Bacilli;Lactobacillales;Streptococcaceae;Lactococcus;Lactococcus cremoris	2	0	2	0	0	1	6	0	11
Bacteria;Bacteria_none;Bacteroidota;Bacteroidia;Bacteroidales;Porphyromonadaceae;Porphyromonas;Porphyromonas asaccharolytica	0	0	0	5	0	0	0	6	11
Bacteria;Bacteria_none;Actinomycetota;Coriobacteriia;Eggerthellales;Eggerthellaceae;Phoenicibacter;Phoenicibacter congonensis	0	0	0	3	0	0	0	7	10
Bacteria;Bacteria_none;Bacillota;Erysipelotrichia;Erysipelotrichales;Erysipelotrichaceae;Bulleidia;Bulleidia sp. zg-1006	0	0	0	2	0	0	0	8	10
Bacteria;Bacteria_none;Bacteroidota;Bacteroidia;Bacteroidales;Tannerellaceae;Parabacteroides;Parabacteroides distasonis	0	0	0	3	0	1	0	6	10
Bacteria;Bacteria_none;Bacillota;Bacilli;Bacillales;Bacillales_Incertae_sedis;Gemella;Gemella haemolysans	0	0	1	1	5	3	0	0	10
Bacteria;Bacteria_none;Pseudomonadota;Gammaproteobacteria;Pasteurellales;Pasteurellaceae;Haemophilus;Haemophilus influenzae	4	0	0	0	6	0	0	0	10
Viruses;Shotokuvirae;Cossaviricota;Papovaviricetes;Zurhausenvirales;Papillomaviridae;Alphapapillomavirus;Alphapapillomavirus 14	0	5	0	0	0	4	0	0	9
Bacteria;Bacteria_none;Bacillota;Bacilli;Lactobacillales;Lactobacillaceae;Lactobacillus;Lactobacillus acidophilus	0	3	0	0	0	6	0	0	9
Bacteria;Bacteria_none;Bacteroidota;Bacteroidia;Bacteroidales;Bacteroidaceae;Bacteroides;Bacteroides caccae	0	1	0	8	0	0	0	0	9
Bacteria;Bacteria_none;Actinomycetota;Actinomycetes;Mycobacteriales;Corynebacteriaceae;Corynebacterium;Corynebacterium kefirresidentii	2	0	0	3	3	0	1	0	9
Bacteria;Bacteria_none;Pseudomonadota;Gammaproteobacteria;Enterobacterales;Enterobacteriaceae;Shigella;Shigella flexneri	0	0	0	0	0	9	0	0	9
Viruses;Shotokuvirae;Cossaviricota;Papovaviricetes;Zurhausenvirales;Papillomaviridae;Alphapapillomavirus;Alphapapillomavirus 10	0	0	0	3	0	0	0	6	9
Eukaryota;Fungi;Ascomycota;Sordariomycetes;Hypocreales;Nectriaceae;Fusarium;Fusarium poae	3	0	0	0	2	2	0	2	9
Bacteria;Bacteria_none;Pseudomonadota;Gammaproteobacteria;Pseudomonadales;Pseudomonadaceae;Pseudomonas;Pseudomonas fluorescens	0	1	0	1	0	0	0	7	9
Bacteria;Bacteria_none;Bacteroidota;Bacteroidia;Bacteroidales;Prevotellaceae;Prevotella;Prevotella sp. E2-28	0	0	0	2	0	0	0	7	9
Bacteria;Bacteria_none;Pseudomonadota;Betaproteobacteria;Neisseriales;Neisseriaceae;Neisseria;Neisseria sicca	2	0	0	0	6	0	0	0	8
Bacteria;Bacteria_none;Bacillota;Clostridia;Eubacteriales;Eubacteriales Family XIII. Incertae Sedis;Mogibacterium;Mogibacterium diversum	0	0	0	2	0	0	0	6	8
Bacteria;Bacteria_none;Pseudomonadota;Gammaproteobacteria;Moraxellales;Moraxellaceae;Acinetobacter;Acinetobacter johnsonii	0	0	0	0	4	0	3	1	8
Bacteria;Bacteria_none;Cyanobacteriota;Cyanophyceae;Pleurocapsales;Dermocarpellaceae;Stanieria;Stanieria cyanosphaera	0	0	0	0	0	8	0	0	8
Bacteria;Bacteria_none;Bacillota;Bacilli;Lactobacillales;Streptococcaceae;Streptococcus;Streptococcus pyogenes	0	4	0	0	0	2	0	1	7
Bacteria;Bacteria_none;Bacteroidota;Flavobacteriia;Flavobacteriales;Flavobacteriaceae;Olleya;Olleya sp. Bg11-27	0	0	0	0	0	0	1	6	7
Bacteria;Bacteria_none;Bacteroidota;Flavobacteriia;Flavobacteriales;Flavobacteriaceae;Lutibacter;Lutibacter sp. A80	0	0	0	2	0	0	0	5	7
Bacteria;Bacteria_none;Bacteroidota;Bacteroidia;Bacteroidales;Bacteroidaceae;Phocaeicola;Phocaeicola coprophilus	0	0	0	0	0	1	0	6	7
Bacteria;Bacteria_none;Cyanobacteriota;Cyanophyceae;Pseudanabaenales;Thermosynechococcaceae;Thermosynechococcus;Thermosynechococcus sp. HN-54	0	0	0	0	0	7	0	0	7
Bacteria;Bacteria_none;Bacillota;Bacilli;Bacillales;Bacillaceae;Cytobacillus;Cytobacillus kochii	0	0	0	0	0	7	0	0	7
Bacteria;Bacteria_none;Bacillota;Bacilli;Lactobacillales;Streptococcaceae;Streptococcus;Streptococcus gordonii	1	0	0	0	3	0	0	3	7
Bacteria;Bacteria_none;Bacillota;Bacilli;Bacillales;Bacillaceae;Bacillus;Bacillus subtilis	0	0	0	0	0	7	0	0	7
Bacteria;Bacteria_none;Bacillota;Bacilli;Lactobacillales;Streptococcaceae;Streptococcus;Streptococcus sp. oral taxon 061	0	0	0	0	1	0	0	5	6
Bacteria;Bacteria_none;Bacillota;Bacilli;Lactobacillales;Streptococcaceae;Streptococcus;Streptococcus sanguinis	2	0	0	0	0	1	2	1	6
Bacteria;Bacteria_none;Mycoplasmatota;Mollicutes;Mycoplasmatales;Mycoplasmataceae;Ureaplasma;Ureaplasma urealyticum	0	3	0	0	0	2	0	1	6
Bacteria;Bacteria_none;Bacteroidota;Bacteroidia;Bacteroidales;Rikenellaceae;Alistipes;Alistipes finegoldii	0	0	0	2	0	0	0	4	6
Bacteria;Bacteria_none;Actinomycetota;Actinomycetes;Candidatus Nanopelagicales;Candidatus Nanopelagicaceae;Candidatus Planktophila;Candidatus Planktophila vernalis	0	0	0	0	0	0	0	6	6
Bacteria;Bacteria_none;Bacillota;Bacillota_Incertae_sedis;Bacillota_Incertae_sedis_Incertae_sedis;Bacillota_Incertae_sedis_Incertae_sedis_Incertae_sedis;Ndongobacter;Ndongobacter massiliensis	0	0	0	2	0	0	0	4	6
Bacteria;Bacteria_none;Bacillota;Clostridia;Eubacteriales;Clostridiaceae;Clostridium;Clostridium perfringens	0	0	0	0	0	0	0	6	6
Bacteria;Bacteria_none;Bacillota;Bacilli;Bacillales;Bacillales_Incertae_sedis;Gemella;Gemella sanguinis	1	0	0	1	2	0	0	2	6
Bacteria;Bacteria_none;Bacteroidota;Bacteroidia;Bacteroidales;Barnesiellaceae;Coprobacter;Coprobacter secundus	0	0	0	0	0	0	0	6	6
Bacteria;Bacteria_none;Bacillota;Negativicutes;Veillonellales;Veillonellaceae;Veillonella;Veillonella atypica	1	1	0	0	1	2	0	1	6
Bacteria;Bacteria_none;Bacillota;Clostridia;Eubacteriales;Clostridiaceae;Clostridium;Clostridium estertheticum	0	0	0	1	0	0	1	4	6
Bacteria;Bacteria_none;Bacillota;Bacilli;Lactobacillales;Streptococcaceae;Streptococcus;Streptococcus salivarius	0	1	0	2	1	0	0	2	6
Bacteria;Bacteria_none;Bacteroidota;Bacteroidia;Bacteroidales;Bacteroidaceae;Bacteroides;Bacteroides heparinolyticus	0	0	0	4	0	0	0	2	6
Bacteria;Bacteria_none;Bacteroidota;Bacteroidia;Bacteroidales;Prevotellaceae;Prevotella;Prevotella sp. Rep29	0	0	0	1	0	0	0	5	6
Bacteria;Bacteria_none;Bacillota;Bacilli;Lactobacillales;Streptococcaceae;Streptococcus;Streptococcus constellatus	0	0	0	0	0	0	0	6	6
Bacteria;Bacteria_none;Bacillota;Bacilli;Bacillales;Staphylococcaceae;Staphylococcus;Staphylococcus saccharolyticus	1	0	2	0	2	0	1	0	6
Bacteria;Bacteria_none;Bacteroidota;Flavobacteriia;Flavobacteriales;Blattabacteriaceae;Blattabacterium;Blattabacterium cuenoti	0	0	0	1	1	0	0	4	6
Eukaryota;Fungi;Ascomycota;Sordariomycetes;Hypocreales;Nectriaceae;Fusarium;Fusarium keratoplasticum	1	2	0	0	0	2	0	1	6
Bacteria;Bacteria_none;Actinomycetota;Coriobacteriia;Eggerthellales;Eggerthellaceae;Berryella;Berryella intestinalis	0	0	0	0	0	0	0	6	6
Bacteria;Bacteria_none;Bacillota;Bacilli;Lactobacillales;Enterococcaceae;Enterococcus;Enterococcus faecium	1	2	0	0	0	0	1	2	6
Eukaryota;Eukaryota_Incertae_sedis;Apicomplexa;Aconoidasida;Haemosporida;Plasmodiidae;Plasmodium;Plasmodium relictum	0	1	0	1	1	2	0	1	6
Bacteria;Bacteria_none;Bacillota;Bacilli;Lactobacillales;Carnobacteriaceae;Granulicatella;Granulicatella elegans	0	0	0	0	0	0	1	5	6
Bacteria;Bacteria_none;Bacillota;Bacilli;Bacillales;Bacillaceae;Bacillus;Bacillus velezensis	0	0	0	0	0	2	0	3	5
Eukaryota;Eukaryota_Incertae_sedis;Eukaryota_Incertae_sedis_Incertae_sedis;Cryptophyceae;Cryptomonadales;Cryptomonadaceae;Cryptomonas;Cryptomonas paramecium	0	0	0	0	0	1	3	1	5
Bacteria;Bacteria_none;Pseudomonadota;Deltaproteobacteria;Desulfovibrionales;Desulfovibrionaceae;Lawsonia;Lawsonia intracellularis	0	0	0	0	0	5	0	0	5
Bacteria;Bacteria_none;Bacillota;Tissierellia;Tissierellales;Peptoniphilaceae;Anaerococcus;Anaerococcus prevotii	0	0	0	3	0	0	0	2	5
Bacteria;Bacteria_none;Pseudomonadota;Gammaproteobacteria;Enterobacterales;Erwiniaceae;Pantoea;Pantoea agglomerans	1	1	0	1	1	0	1	0	5
Bacteria;Bacteria_none;Bacillota;Clostridia;Eubacteriales;Eubacteriales_Incertae_sedis;Fenollaria;Fenollaria sporofastidiosus	0	0	0	1	0	0	0	4	5
Bacteria;Bacteria_none;Bacillota;Bacilli;Lactobacillales;Lactobacillaceae;Companilactobacillus;Companilactobacillus zhachilii	0	0	0	0	0	0	0	5	5
Bacteria;Bacteria_none;Actinomycetota;Actinomycetes;Bifidobacteriales;Bifidobacteriaceae;Bifidobacterium;Bifidobacterium longum	0	0	0	0	0	0	0	5	5
Bacteria;Bacteria_none;Bacillota;Bacilli;Lactobacillales;Streptococcaceae;Streptococcus;Streptococcus sp. LPB0220	0	0	0	1	3	0	0	1	5
Bacteria;Bacteria_none;Pseudomonadota;Gammaproteobacteria;Enterobacterales;Enterobacteriaceae;Salmonella;Salmonella enterica	0	0	0	1	0	0	4	0	5
Bacteria;Bacteria_none;Bacteroidota;Bacteroidia;Bacteroidales;Bacteroidaceae;Bacteroides;Bacteroides coprosuis	0	0	0	1	0	0	0	4	5
Bacteria;Bacteria_none;Actinomycetota;Coriobacteriia;Eggerthellales;Eggerthellaceae;Cryptobacterium;Cryptobacterium curtum	0	0	0	2	0	0	0	3	5
Bacteria;Bacteria_none;Bacillota;Clostridia;Eubacteriales;Oscillospiraceae;Fastidiosipila;Fastidiosipila sanguinis	0	0	0	1	2	0	0	2	5
Bacteria;Bacteria_none;Bacteroidota;Sphingobacteriia;Sphingobacteriales;Sphingobacteriaceae;Pedobacter;Pedobacter ginsengisoli	0	0	0	0	0	0	0	5	5
Bacteria;Bacteria_none;Actinomycetota;Actinomycetes;Mycobacteriales;Corynebacteriaceae;Corynebacterium;Corynebacterium glucuronolyticum	1	0	1	0	2	1	0	0	5
Bacteria;Bacteria_none;Bacteroidota;Flavobacteriia;Flavobacteriales;Weeksellaceae;Cloacibacterium;Cloacibacterium normanense	0	3	0	0	0	0	2	0	5
Bacteria;Bacteria_none;Bacteroidota;Bacteroidia;Bacteroidales;Bacteroidaceae;Bacteroides;Bacteroides nordii	0	0	0	1	0	2	0	2	5
Bacteria;Bacteria_none;Bacteroidota;Flavobacteriia;Flavobacteriales;Weeksellaceae;Chryseobacterium;Chryseobacterium sp. MEBOG07	0	0	0	0	0	0	1	4	5
Bacteria;Bacteria_none;Pseudomonadota;Alphaproteobacteria;Rhodobacterales;Paracoccaceae;Paracoccus;Paracoccus yeei	0	0	0	0	0	3	2	0	5
Bacteria;Bacteria_none;Bacteroidota;Bacteroidia;Bacteroidales;Odoribacteraceae;Butyricimonas;Butyricimonas faecalis	0	0	0	0	0	0	0	4	4
Bacteria;Bacteria_none;Bacteroidota;Bacteroidia;Bacteroidales;Paludibacteraceae;Paludibacter;Paludibacter propionicigenes	0	0	0	2	1	0	0	1	4
Bacteria;Bacteria_none;Pseudomonadota;Gammaproteobacteria;Xanthomonadales;Xanthomonadaceae;Stenotrophomonas;Stenotrophomonas maltophilia	0	0	0	0	3	0	0	1	4
Bacteria;Bacteria_none;Pseudomonadota;Betaproteobacteria;Burkholderiales;Burkholderiaceae;Paraburkholderia;Paraburkholderia edwinii	0	0	0	0	1	0	0	3	4
Bacteria;Bacteria_none;Bacillota;Clostridia;Eubacteriales;Clostridiaceae;Clostridium;Clostridium butyricum	0	0	0	0	0	0	0	4	4
Bacteria;Bacteria_none;Spirochaetota;Spirochaetia;Brachyspirales;Brachyspiraceae;Brachyspira;Brachyspira pilosicoli	0	1	0	0	0	0	0	3	4
Bacteria;Bacteria_none;Bacillota;Bacilli;Lactobacillales;Lactobacillaceae;Lactobacillus;Lactobacillus acetotolerans	0	2	0	0	0	2	0	0	4
Bacteria;Bacteria_none;Fusobacteriota;Fusobacteriia;Fusobacteriales;Leptotrichiaceae;Leptotrichia;Leptotrichia hongkongensis	0	0	0	0	0	0	1	3	4
Bacteria;Bacteria_none;Bacillota;Bacilli;Lactobacillales;Streptococcaceae;Streptococcus;Streptococcus suis	0	0	2	0	0	2	0	0	4
Bacteria;Bacteria_none;Pseudomonadota;Gammaproteobacteria;Enterobacterales;Enterobacteriaceae;Enterobacter;Enterobacter cloacae	0	0	0	0	0	0	0	4	4
Bacteria;Bacteria_none;Pseudomonadota;Alphaproteobacteria;Hyphomicrobiales;Nitrobacteraceae;Bradyrhizobium;Bradyrhizobium sp. CCBAU 53340	0	0	0	0	0	0	0	4	4
Bacteria;Bacteria_none;Actinomycetota;Actinomycetes;Propionibacteriales;Propionibacteriaceae;Cutibacterium;Cutibacterium granulosum	1	0	0	0	0	2	1	0	4
Eukaryota;Eukaryota_Incertae_sedis;Apicomplexa;Aconoidasida;Haemosporida;Plasmodiidae;Plasmodium;Plasmodium vinckei	0	0	0	0	2	1	0	1	4
Bacteria;Bacteria_none;Actinomycetota;Rubrobacteria;Rubrobacterales;Baekduiaceae;Baekduia;Baekduia sp. 0141_2	0	1	0	0	0	3	0	0	4
Bacteria;Bacteria_none;Bacteroidota;Cytophagia;Cytophagales;Flammeovirgaceae;Flammeovirga;Flammeovirga kamogawensis	0	0	0	2	0	1	0	1	4
Bacteria;Bacteria_none;Bacteroidota;Cytophagia;Cytophagales;Hymenobacteraceae;Pontibacter;Pontibacter sp. SGAir0037	0	0	0	0	0	0	1	3	4
Bacteria;Bacteria_none;Cyanobacteriota;Cyanophyceae;Pseudanabaenales;Pseudanabaenaceae;Pseudanabaena;Pseudanabaena sp. Chao 1811	0	0	0	0	0	0	0	4	4
Bacteria;Bacteria_none;Bacillota;Negativicutes;Veillonellales;Veillonellaceae;Megasphaera;Megasphaera stantonii	0	0	0	0	0	0	0	4	4
Bacteria;Bacteria_none;Bacillota;Bacilli;Lactobacillales;Lactobacillaceae;Lactobacillus;Lactobacillus sp. PV037	0	0	0	0	0	4	0	0	4
Bacteria;Bacteria_none;Bacillota;Bacilli;Lactobacillales;Lactobacillaceae;Ligilactobacillus;Ligilactobacillus salivarius	0	0	0	0	0	1	0	3	4
Bacteria;Bacteria_none;Actinomycetota;Actinomycetes;Actinomycetales;Actinomycetaceae;Actinomyces;Actinomyces oris	2	0	0	0	2	0	0	0	4
Bacteria;Bacteria_none;Pseudomonadota;Deltaproteobacteria;Desulfovibrionales;Desulfovibrionaceae;Pseudodesulfovibrio;Pseudodesulfovibrio piezophilus	0	0	0	1	0	0	0	3	4
Bacteria;Bacteria_none;Bacteroidota;Bacteroidia;Bacteroidales;Bacteroidaceae;Bacteroides;Bacteroides zhangwenhongii	0	0	0	2	2	0	0	0	4
Bacteria;Bacteria_none;Pseudomonadota;Betaproteobacteria;Neisseriales;Neisseriaceae;Neisseria;Neisseria macacae	4	0	0	0	0	0	0	0	4
Bacteria;Bacteria_none;Bacteroidota;Flavobacteriia;Flavobacteriales;Flavobacteriaceae;Flavobacterium;Flavobacterium sp. IMCC36792	0	0	0	3	0	0	0	1	4
Bacteria;Bacteria_none;Bacillota;Bacilli;Lactobacillales;Streptococcaceae;Lactococcus;Lactococcus garvieae	0	0	0	0	0	0	0	4	4
Bacteria;Bacteria_none;Bacillota;Bacilli;Lactobacillales;Streptococcaceae;Lactococcus;Lactococcus lactis	1	1	0	0	0	0	2	0	4
Bacteria;Bacteria_none;Cyanobacteriota;Cyanophyceae;Nostocales;Aphanizomenonaceae;Anabaenopsis;Anabaenopsis circularis	0	0	0	0	0	0	0	4	4
Bacteria;Bacteria_none;Pseudomonadota;Gammaproteobacteria;Alteromonadales;Pseudoalteromonadaceae;Pseudoalteromonas;Pseudoalteromonas rubra	0	0	1	0	2	0	1	0	4
Bacteria;Bacteria_none;Actinomycetota;Coriobacteriia;Eggerthellales;Eggerthellaceae;Eggerthella;Eggerthella sp. YY7918	0	0	0	0	0	0	0	4	4
Bacteria;Bacteria_none;Bacillota;Bacilli;Lactobacillales;Lactobacillaceae;Lactobacillus;Lactobacillus delbrueckii	0	1	0	0	0	1	2	0	4
Bacteria;Bacteria_none;Pseudomonadota;Gammaproteobacteria;Vibrionales;Vibrionaceae;Vibrio;Vibrio parahaemolyticus	0	0	0	1	0	0	0	2	3
Bacteria;Bacteria_none;Bacteroidota;Flavobacteriia;Flavobacteriales;Weeksellaceae;Ornithobacterium;Ornithobacterium rhinotracheale	0	0	0	0	0	0	1	2	3
Bacteria;Bacteria_none;Pseudomonadota;Gammaproteobacteria;Xanthomonadales;Xanthomonadaceae;Xanthomonas;Xanthomonas hydrangeae	0	0	0	2	0	0	0	1	3
Bacteria;Bacteria_none;Bacteroidota;Bacteroidia;Bacteroidales;Prevotellaceae;Prevotella;Prevotella sp. E13-17	0	0	0	0	0	0	0	3	3
Eukaryota;Eukaryota_Incertae_sedis;Apicomplexa;Aconoidasida;Haemosporida;Plasmodiidae;Plasmodium;Plasmodium knowlesi	0	0	0	2	0	0	1	0	3
Bacteria;Bacteria_none;Pseudomonadota;Betaproteobacteria;Neisseriales;Neisseriaceae;Neisseria;Neisseria elongata	2	0	0	0	1	0	0	0	3
Bacteria;Bacteria_none;Bacteroidota;Flavobacteriia;Flavobacteriales;Weeksellaceae;Empedobacter;Empedobacter falsenii	0	0	0	0	0	3	0	0	3
Eukaryota;Eukaryota_Incertae_sedis;Euglenozoa;Kinetoplastea;Trypanosomatida;Trypanosomatidae;Leishmania;Leishmania major	0	0	0	1	0	1	0	1	3
Bacteria;Bacteria_none;Bacteroidota;Flavobacteriia;Flavobacteriales;Flavobacteriaceae;Polaribacter;Polaribacter pectinis	0	0	0	0	0	0	0	3	3
Bacteria;Bacteria_none;Bacteroidota;Flavobacteriia;Flavobacteriales;Flavobacteriaceae;Flavobacterium;Flavobacterium sp. N2038	0	0	0	0	0	3	0	0	3
Bacteria;Bacteria_none;Bacillota;Bacilli;Bacillales;Bacillales_Incertae_sedis;Gemella;Gemella sp. oral taxon 928	0	0	0	0	0	0	0	3	3
Bacteria;Bacteria_none;Bacteroidota;Flavobacteriia;Flavobacteriales;Flavobacteriaceae;Flavobacterium;Flavobacterium sp. N1846	0	0	0	0	1	0	0	2	3
Bacteria;Bacteria_none;Bacillota;Bacilli;Bacillales;Listeriaceae;Listeria;Listeria welshimeri	0	0	0	0	0	0	0	3	3
Bacteria;Bacteria_none;Bacillota;Bacilli;Bacillales;Paenibacillaceae;Paenibacillus;Paenibacillus sp. 19GGS1-52	0	0	0	1	0	0	0	2	3
Bacteria;Bacteria_none;Bacillota;Bacilli;Bacillales;Staphylococcaceae;Mammaliicoccus;Mammaliicoccus vitulinus	0	0	0	0	0	0	0	3	3
Eukaryota;Fungi;Basidiomycota;Tremellomycetes;Tremellales;Cryptococcaceae;Cryptococcus;Cryptococcus gattii VGI	0	3	0	0	0	0	0	0	3
Eukaryota;Fungi;Basidiomycota;Agaricomycetes;Agaricales;Marasmiaceae;Marasmius;Marasmius oreades	0	0	0	0	2	0	1	0	3
Bacteria;Bacteria_none;Bacteroidota;Flavobacteriia;Flavobacteriales;Flavobacteriaceae;Flavobacterium;Flavobacterium sp. 140616W15	0	0	0	0	0	0	0	3	3
Bacteria;Bacteria_none;Bacteroidota;Flavobacteriia;Flavobacteriales;Flavobacteriaceae;Capnocytophaga;Capnocytophaga stomatis	0	0	0	2	0	0	0	1	3
Bacteria;Bacteria_none;Bacillota;Bacilli;Bacillales;Staphylococcaceae;Staphylococcus;Staphylococcus sp. NRL 22/194	0	0	0	1	0	0	1	1	3
Bacteria;Bacteria_none;Bacteroidota;Flavobacteriia;Flavobacteriales;Flavobacteriaceae;Winogradskyella;Winogradskyella forsetii	0	0	0	0	1	0	0	2	3
Eukaryota;Fungi;Ascomycota;Sordariomycetes;Hypocreales;Nectriaceae;Fusarium;Fusarium fujikuroi	0	0	0	0	0	0	3	0	3
Bacteria;Bacteria_none;Candidatus Cloacimonetes;Candidatus Cloacimonetes_Incertae_sedis;Candidatus Cloacimonetes_Incertae_sedis_Incertae_sedis;Candidatus Cloacimonetes_Incertae_sedis_Incertae_sedis_Incertae_sedis;Candidatus Cloacimonas;Candidatus Cloacimonas acidaminovorans	0	1	0	1	0	0	0	1	3
Bacteria;Bacteria_none;Bacteroidota;Bacteroidia;Bacteroidales;Prevotellaceae;Prevotella;Prevotella sp. oral taxon 475	0	0	0	0	0	0	0	3	3
Bacteria;Bacteria_none;Cyanobacteriota;Cyanophyceae;Nostocales;Rivulariaceae;Rivularia;Rivularia sp. PCC 7116	0	0	0	0	0	0	0	3	3
Bacteria;Bacteria_none;Pseudomonadota;Gammaproteobacteria;Pasteurellales;Pasteurellaceae;Haemophilus;Haemophilus haemolyticus	0	0	0	1	1	1	0	0	3
Bacteria;Bacteria_none;Bacillota;Clostridia;Eubacteriales;Clostridiaceae;Clostridium;Clostridium tyrobutyricum	0	0	0	1	0	0	0	2	3
Bacteria;Bacteria_none;Bacillota;Clostridia;Eubacteriales;Lachnospiraceae;Lachnoanaerobaculum;Lachnoanaerobaculum umeaense	0	0	0	0	0	1	0	2	3
Bacteria;Bacteria_none;Bacteroidota;Flavobacteriia;Flavobacteriales;Flavobacteriaceae;Polaribacter;Polaribacter sp. ALD11	0	0	0	3	0	0	0	0	3
Bacteria;Bacteria_none;Pseudomonadota;Gammaproteobacteria;Enterobacterales;Enterobacteriaceae;Citrobacter;Citrobacter freundii	0	0	0	0	0	0	0	3	3
Bacteria;Bacteria_none;Bacillota;Clostridia;Eubacteriales;Oscillospiraceae;Ruminiclostridium;Ruminiclostridium herbifermentans	0	0	1	0	0	0	0	2	3
Bacteria;Bacteria_none;Bacillota;Clostridia;Eubacteriales;Peptostreptococcaceae;Filifactor;Filifactor alocis	0	0	0	2	0	0	0	1	3
Bacteria;Bacteria_none;Pseudomonadota;Gammaproteobacteria;Alteromonadales;Pseudoalteromonadaceae;Pseudoalteromonas;Pseudoalteromonas luteoviolacea	0	1	0	1	0	0	0	1	3
Bacteria;Bacteria_none;Pseudomonadota;Epsilonproteobacteria;Campylobacterales;Campylobacteraceae;Campylobacter;Campylobacter peloridis	0	0	0	0	0	0	0	3	3
Bacteria;Bacteria_none;Bacillota;Negativicutes;Veillonellales;Veillonellaceae;Megasphaera;Megasphaera elsdenii	0	0	0	0	0	1	0	2	3
Bacteria;Bacteria_none;Bacillota;Negativicutes;Veillonellales;Veillonellaceae;Veillonella;Veillonella rogosae	0	0	0	0	0	0	0	3	3
Bacteria;Bacteria_none;Pseudomonadota;Epsilonproteobacteria;Campylobacterales;Campylobacteraceae;Campylobacter;Campylobacter blaseri	0	0	0	2	0	0	0	1	3
Bacteria;Bacteria_none;Pseudomonadota;Betaproteobacteria;Neisseriales;Chromobacteriaceae;Deefgea;Deefgea piscis	1	0	0	2	0	0	0	0	3
Bacteria;Bacteria_none;Pseudomonadota;Betaproteobacteria;Nitrosomonadales;Methylophilaceae;Methyloradius;Methyloradius palustris	0	0	0	0	0	0	0	3	3
Bacteria;Bacteria_none;Bacillota;Tissierellia;Tissierellia_Incertae_sedis;Tissierellia_Incertae_sedis_Incertae_sedis;Ezakiella;Ezakiella massiliensis	0	0	0	1	0	0	0	2	3
Bacteria;Bacteria_none;Bacteroidota;Bacteroidia;Bacteroidales;Bacteroidaceae;Bacteroides;Bacteroides intestinalis	0	0	0	1	0	0	0	2	3
Bacteria;Bacteria_none;Bacteroidota;Bacteroidia;Bacteroidales;Bacteroidaceae;Bacteroides;Bacteroides cellulosilyticus	0	0	0	0	0	0	0	3	3
Bacteria;Bacteria_none;Bacillota;Clostridia;Eubacteriales;Eubacteriales Family XIII. Incertae Sedis;Emergencia;Emergencia timonensis	0	0	0	1	0	0	0	2	3
Bacteria;Bacteria_none;Pseudomonadota;Betaproteobacteria;Burkholderiales;Comamonadaceae;Melaminivora;Melaminivora suipulveris	0	1	0	0	0	0	0	2	3
Bacteria;Bacteria_none;Pseudomonadota;Gammaproteobacteria;Nevskiales;Steroidobacteraceae;Steroidobacter;Steroidobacter denitrificans	0	0	0	1	1	0	0	1	3
Bacteria;Bacteria_none;Bacillota;Clostridia;Eubacteriales;Clostridiaceae;Clostridium;Clostridium beijerinckii	0	0	0	0	0	1	0	2	3
Bacteria;Bacteria_none;Chloroflexota;Chloroflexia;Chloroflexales;Chloroflexaceae;Chloroflexus;Chloroflexus aurantiacus	0	0	0	0	0	0	0	3	3
Bacteria;Bacteria_none;Pseudomonadota;Gammaproteobacteria;Enterobacterales;Pectobacteriaceae;Pectobacterium;Pectobacterium parvum	0	0	0	1	0	0	0	2	3
Bacteria;Bacteria_none;Pseudomonadota;Gammaproteobacteria;Enterobacterales;Morganellaceae;Providencia;Providencia stuartii	0	0	0	0	0	0	0	3	3
Bacteria;Bacteria_none;Pseudomonadota;Gammaproteobacteria;Enterobacterales;Morganellaceae;Providencia;Providencia alcalifaciens	0	0	0	0	0	2	0	1	3
Bacteria;Bacteria_none;Cyanobacteriota;Cyanophyceae;Synechococcales;Prochlorococcaceae;Prochlorococcus;Prochlorococcus marinus	0	0	0	0	0	1	1	1	3
Bacteria;Bacteria_none;Pseudomonadota;Gammaproteobacteria;Enterobacterales;Erwiniaceae;Buchnera;Buchnera aphidicola	0	0	1	0	1	1	0	0	3
Bacteria;Bacteria_none;Cyanobacteriota;Cyanophyceae;Synechococcales;Synechococcaceae;Synechococcus;Synechococcus sp. PCC 7502	0	0	0	0	0	0	0	3	3
Bacteria;Bacteria_none;Bacillota;Bacilli;Lactobacillales;Streptococcaceae;Streptococcus;Streptococcus porcinus	0	0	0	0	0	0	0	3	3
Bacteria;Bacteria_none;Fusobacteriota;Fusobacteriia;Fusobacteriales;Fusobacteriaceae;Fusobacterium;Fusobacterium gonidiaformans	0	0	0	2	0	0	0	1	3
Bacteria;Bacteria_none;Fusobacteriota;Fusobacteriia;Fusobacteriales;Leptotrichiaceae;Leptotrichia;Leptotrichia trevisanii	0	0	0	3	0	0	0	0	3
Bacteria;Bacteria_none;Fusobacteriota;Fusobacteriia;Fusobacteriales;Leptotrichiaceae;Streptobacillus;Streptobacillus moniliformis	0	0	0	2	0	0	0	1	3
Bacteria;Bacteria_none;Bacillota;Bacilli;Lactobacillales;Streptococcaceae;Streptococcus;Streptococcus sp. HSISM1	2	0	0	0	0	0	0	1	3
Bacteria;Bacteria_none;Mycoplasmatota;Mollicutes;Mycoplasmatales;Mycoplasmataceae;Mycoplasmopsis;Mycoplasmopsis maculosa	0	0	0	2	0	0	0	1	3
Bacteria;Bacteria_none;Pseudomonadota;Alphaproteobacteria;Hyphomicrobiales;Methylobacteriaceae;Methylorubrum;Methylorubrum extorquens	0	0	0	0	2	0	1	0	3
Bacteria;Bacteria_none;Bacillota;Bacilli;Lactobacillales;Streptococcaceae;Streptococcus;Streptococcus toyakuensis	1	0	1	0	1	0	0	0	3
Bacteria;Bacteria_none;Bacteroidota;Flavobacteriia;Flavobacteriales;Flavobacteriaceae;Tenacibaculum;Tenacibaculum sp. SZ-18	0	0	0	0	0	0	0	3	3
Archaea;Archaea_none;Crenarchaeota;Thermoprotei;Acidilobales;Caldisphaeraceae;Caldisphaera;Caldisphaera lagunensis	0	0	0	0	0	0	0	3	3
Bacteria;Bacteria_none;Actinomycetota;Coriobacteriia;Coriobacteriales;Atopobiaceae;Lancefieldella;Lancefieldella parvula	0	0	0	2	0	0	0	1	3
Bacteria;Bacteria_none;Actinomycetota;Actinomycetes;Actinomycetales;Actinomycetaceae;Arcanobacterium;Arcanobacterium haemolyticum	0	0	0	1	0	0	0	2	3
Bacteria;Bacteria_none;Actinomycetota;Actinomycetes;Propionibacteriales;Propionibacteriaceae;Vaginimicrobium;Vaginimicrobium propionicum	0	0	0	0	0	0	0	3	3
Bacteria;Bacteria_none;Actinomycetota;Actinomycetes;Mycobacteriales;Corynebacteriaceae;Corynebacterium;Corynebacterium diphtheriae	0	0	0	0	0	0	3	0	3
Bacteria;Bacteria_none;Actinomycetota;Actinomycetes;Micrococcales;Micrococcaceae;Rothia;Rothia dentocariosa	2	0	0	0	1	0	0	0	3
Bacteria;Bacteria_none;Bacillota;Bacilli;Bacillales;Bacillaceae;Bacillus;Bacillus dafuensis	0	1	0	0	0	0	0	2	3
Bacteria;Bacteria_none;Actinomycetota;Coriobacteriia;Eggerthellales;Eggerthellaceae;Eggerthella;Eggerthella lenta	0	0	0	0	0	0	0	3	3
Bacteria;Bacteria_none;Actinomycetota;Actinomycetes;Micrococcales;Micrococcaceae;Micrococcus;Micrococcus sp. A7	0	0	3	0	0	0	0	0	3
Bacteria;Bacteria_none;Actinomycetota;Coriobacteriia;Eggerthellales;Eggerthellaceae;Arabiibacter;Arabiibacter massiliensis	0	0	0	3	0	0	0	0	3
Bacteria;Bacteria_none;Actinomycetota;Actinomycetes;Kitasatosporales;Streptomycetaceae;Streptomyces;Streptomyces sp. Go-475	0	0	0	3	0	0	0	0	3
Archaea;Archaea_none;Euryarchaeota;Methanomicrobia;Methanosarcinales;Methanosarcinaceae;Methanosarcina;Methanosarcina barkeri	0	0	0	0	0	1	0	2	3
Bacteria;Bacteria_none;Actinomycetota;Actinomycetes;Kitasatosporales;Streptomycetaceae;Streptomyces;Streptomyces lydicus	0	2	0	0	0	1	0	0	3
Bacteria;Bacteria_none;Bacteroidota;Flavobacteriia;Flavobacteriales;Weeksellaceae;Chryseobacterium;Chryseobacterium carnipullorum	0	0	0	0	0	0	0	2	2
Bacteria;Bacteria_none;Pseudomonadota;Gammaproteobacteria;Pasteurellales;Pasteurellaceae;Actinobacillus;Actinobacillus pleuropneumoniae	0	0	0	0	0	0	0	2	2
Bacteria;Bacteria_none;Actinomycetota;Actinomycetes;Propionibacteriales;Kribbellaceae;Kribbella;Kribbella sp. CA-293567	0	0	0	0	0	0	0	2	2
Bacteria;Bacteria_none;Bacteroidota;Flavobacteriia;Flavobacteriales;Schleiferiaceae;Owenweeksia;Owenweeksia hongkongensis	0	0	0	0	0	0	0	2	2
Bacteria;Bacteria_none;Actinomycetota;Actinomycetes;Bifidobacteriales;Bifidobacteriaceae;Bifidobacterium;Bifidobacterium adolescentis	0	0	0	0	0	0	0	2	2
Bacteria;Bacteria_none;Pseudomonadota;Gammaproteobacteria;Oceanospirillales;Halomonadaceae;Halomonas;Halomonas sp. HG01	0	0	0	0	0	0	2	0	2
Bacteria;Bacteria_none;Bacteroidota;Flavobacteriia;Flavobacteriales;Flavobacteriaceae;Winogradskyella;Winogradskyella sp. MH6	0	0	0	0	0	1	0	1	2
Bacteria;Bacteria_none;Actinomycetota;Actinomycetes;Micrococcales;Dermabacteraceae;Dermabacter;Dermabacter jinjuensis	0	0	0	0	0	0	0	2	2
Bacteria;Bacteria_none;Bacillota;Clostridia;Eubacteriales;Clostridiaceae;Clostridium;Clostridium manihotivorum	0	0	0	0	0	1	0	1	2
Bacteria;Bacteria_none;Bacillota;Clostridia;Eubacteriales;Clostridiaceae;Clostridium;Clostridium sp. JN-1	0	0	0	0	0	0	1	1	2
Bacteria;Bacteria_none;Pseudomonadota;Betaproteobacteria;Burkholderiales;Burkholderiaceae;Lautropia;Lautropia mirabilis	0	0	0	0	2	0	0	0	2
Bacteria;Bacteria_none;Actinomycetota;Actinomycetes;Micrococcales;Dermabacteraceae;Dermabacter;Dermabacter vaginalis	0	0	1	0	0	0	0	1	2
Bacteria;Bacteria_none;Bacteroidota;Flavobacteriia;Flavobacteriales;Flavobacteriaceae;Tenacibaculum;Tenacibaculum pacificus	0	0	0	0	0	1	1	0	2
Bacteria;Bacteria_none;Bacillota;Clostridia;Eubacteriales;Clostridiaceae;Clostridium;Clostridium chauvoei	0	0	0	0	0	0	2	0	2
Bacteria;Bacteria_none;Actinomycetota;Actinomycetes;Bifidobacteriales;Bifidobacteriaceae;Bifidobacterium;Bifidobacterium animalis	0	0	0	2	0	0	0	0	2
Bacteria;Bacteria_none;Bacillota;Clostridia;Eubacteriales;Eubacteriales_Incertae_sedis;Fenollaria;Fenollaria massiliensis	0	0	0	1	0	0	0	1	2
Bacteria;Bacteria_none;Actinomycetota;Actinomycetes;Mycobacteriales;Nocardiaceae;Rhodococcus;Rhodococcus sp. P-2	0	0	0	0	2	0	0	0	2
Bacteria;Bacteria_none;Pseudomonadota;Gammaproteobacteria;Moraxellales;Moraxellaceae;Psychrobacter;Psychrobacter arenosus	0	0	0	0	0	1	1	0	2
Bacteria;Bacteria_none;Bacteroidota;Flavobacteriia;Flavobacteriales;Flavobacteriaceae;Siansivirga;Siansivirga zeaxanthinifaciens	0	0	0	0	0	0	0	2	2
Bacteria;Bacteria_none;Pseudomonadota;Gammaproteobacteria;Moraxellales;Moraxellaceae;Acinetobacter;Acinetobacter wuhouensis	0	0	0	0	0	0	0	2	2
Bacteria;Bacteria_none;Bacteroidota;Flavobacteriia;Flavobacteriales;Flavobacteriaceae;Salegentibacter;Salegentibacter salegens	0	0	0	1	0	0	0	1	2
Bacteria;Bacteria_none;Bacteroidota;Flavobacteriia;Flavobacteriales;Flavobacteriaceae;Polaribacter;Polaribacter vadi	0	0	0	1	0	0	0	1	2
Bacteria;Bacteria_none;Actinomycetota;Actinomycetes;Micrococcales;Dermabacteraceae;Devriesea;Devriesea agamarum	1	0	0	0	0	1	0	0	2
Bacteria;Bacteria_none;Bacillota;Clostridia;Eubacteriales;Lachnospiraceae;Mediterraneibacter;[Ruminococcus] lactaris	0	0	0	0	0	0	0	2	2
Bacteria;Bacteria_none;Actinomycetota;Actinomycetes;Kitasatosporales;Streptomycetaceae;Streptomyces;Streptomyces sp. 3211	0	0	0	0	0	0	2	0	2
Bacteria;Bacteria_none;Bacillota;Clostridia;Eubacteriales;Lachnospiraceae;Simiaoa;Simiaoa sunii	0	0	0	0	0	0	0	2	2
Bacteria;Bacteria_none;Pseudomonadota;Betaproteobacteria;Burkholderiales;Burkholderiaceae;Burkholderia;Burkholderia glumae	0	0	0	0	0	0	2	0	2
Bacteria;Bacteria_none;Bacteroidota;Flavobacteriia;Flavobacteriales;Weeksellaceae;Elizabethkingia;Elizabethkingia meningoseptica	0	0	0	0	0	0	0	2	2
Bacteria;Bacteria_none;Pseudomonadota;Betaproteobacteria;Burkholderiales;Burkholderiaceae;Burkholderia;Burkholderia cenocepacia	0	0	0	0	0	0	2	0	2
Bacteria;Bacteria_none;Bacteroidota;Sphingobacteriia;Sphingobacteriales;Sphingobacteriaceae;Solitalea;Solitalea canadensis	0	0	0	0	0	0	0	2	2
Bacteria;Bacteria_none;Bacillota;Bacilli;Lactobacillales;Lactobacillaceae;Pediococcus;Pediococcus acidilactici	0	1	0	0	0	0	0	1	2
Bacteria;Bacteria_none;Bacillota;Bacilli;Lactobacillales;Lactobacillaceae;Pediococcus;Pediococcus claussenii	0	0	0	0	0	0	0	2	2
Bacteria;Bacteria_none;Actinomycetota;Actinomycetes;Streptosporangiales;Thermomonosporaceae;Actinomadura;Actinomadura madurae	1	0	0	0	1	0	0	0	2
Bacteria;Bacteria_none;Pseudomonadota;Gammaproteobacteria;Vibrionales;Vibrionaceae;Vibrio;Vibrio splendidus	0	0	0	2	0	0	0	0	2
Bacteria;Bacteria_none;Bacillota;Bacilli;Lactobacillales;Streptococcaceae;Streptococcus;Streptococcus equi	0	0	0	1	0	0	0	1	2
Bacteria;Bacteria_none;Pseudomonadota;Gammaproteobacteria;Vibrionales;Vibrionaceae;Vibrio;Vibrio aquimaris	0	0	0	0	1	1	0	0	2
Bacteria;Bacteria_none;Pseudomonadota;Alphaproteobacteria;Rickettsiales;Anaplasmataceae;Wolbachia;Candidatus Wolbachia massiliensis	0	0	0	0	0	0	0	2	2
Bacteria;Bacteria_none;Bacillota;Bacilli;Lactobacillales;Streptococcaceae;Streptococcus;Streptococcus infantis	1	0	0	1	0	0	0	0	2
Bacteria;Bacteria_none;Bacillota;Bacilli;Lactobacillales;Streptococcaceae;Streptococcus;Streptococcus iniae	0	0	0	1	0	0	0	1	2
Bacteria;Bacteria_none;Actinomycetota;Actinomycetes;Pseudonocardiales;Pseudonocardiaceae;Amycolatopsis;Amycolatopsis sp. DSM 110486	0	2	0	0	0	0	0	0	2
Bacteria;Bacteria_none;Bacillota;Bacilli;Lactobacillales;Streptococcaceae;Streptococcus;Streptococcus parasanguinis	0	0	0	0	0	0	1	1	2
Bacteria;Bacteria_none;Bacillota;Bacilli;Lactobacillales;Streptococcaceae;Streptococcus;Streptococcus parasuis	0	0	1	0	0	0	0	1	2
Bacteria;Bacteria_none;Pseudomonadota;Alphaproteobacteria;Sphingomonadales;Sphingomonadaceae;Aquisediminimonas;Aquisediminimonas profunda	0	0	0	0	0	0	0	2	2
Bacteria;Bacteria_none;Bacteroidota;Flavobacteriia;Flavobacteriales;Weeksellaceae;Cloacibacterium;Cloacibacterium caeni	0	2	0	0	0	0	0	0	2
Bacteria;Bacteria_none;Bacteroidota;Sphingobacteriia;Sphingobacteriales;Sphingobacteriaceae;Pedobacter;Pedobacter sp. PACM 27299	0	0	0	0	0	0	1	1	2
Bacteria;Bacteria_none;Actinomycetota;Actinomycetes;Pseudonocardiales;Pseudonocardiaceae;Actinokineospora;Actinokineospora sp. UTMC 2448	0	0	0	1	0	0	0	1	2
Bacteria;Bacteria_none;Pseudomonadota;Gammaproteobacteria;Pseudomonadales;Pseudomonadaceae;Pseudomonas;Pseudomonas sp. ABC1	0	0	0	0	0	2	0	0	2
Bacteria;Bacteria_none;Bacteroidota;Saprospiria;Saprospirales;Saprospiraceae;Saprospira;Saprospira grandis	0	0	0	0	0	1	0	1	2
Bacteria;Bacteria_none;Bacillota;Bacilli;Lactobacillales;Streptococcaceae;Streptococcus;Streptococcus sp. Marseille-Q3533	0	0	0	0	0	0	0	2	2
Bacteria;Bacteria_none;Bacillota;Bacilli;Lactobacillales;Streptococcaceae;Streptococcus;Streptococcus sp. Marseille-Q6470	0	0	0	0	1	0	0	1	2
Bacteria;Bacteria_none;Bacillota;Bacilli;Lactobacillales;Streptococcaceae;Streptococcus;Streptococcus sp. NPS 308	0	0	0	0	1	1	0	0	2
Bacteria;Bacteria_none;Actinomycetota;Actinomycetes;Propionibacteriales;Propionibacteriaceae;Arachnia;Arachnia rubra	0	0	2	0	0	0	0	0	2
Bacteria;Bacteria_none;Actinomycetota;Actinomycetes;Propionibacteriales;Nocardioidaceae;Solicola;Solicola gregarius	0	0	0	1	0	0	0	1	2
Bacteria;Bacteria_none;Pseudomonadota;Gammaproteobacteria;Pseudomonadales;Pseudomonadaceae;Pseudomonas;Pseudomonas plecoglossicida	0	0	2	0	0	0	0	0	2
Bacteria;Bacteria_none;Bacillota;Clostridia;Eubacteriales;Oscillospiraceae;Acetivibrio;Acetivibrio thermocellus	0	0	0	0	0	0	0	2	2
Bacteria;Bacteria_none;Bacillota;Clostridia;Eubacteriales;Clostridiaceae;Clostridium;Clostridium argentinense	0	0	0	0	0	0	0	2	2
Bacteria;Bacteria_none;Actinomycetota;Actinomycetes;Micrococcales;Intrasporangiaceae;Janibacter;Janibacter indicus	0	0	1	0	0	1	0	0	2
Bacteria;Bacteria_none;Actinomycetota;Actinomycetes;Propionibacteriales;Propionibacteriaceae;Cutibacterium;Cutibacterium modestum	0	0	0	0	0	0	2	0	2
Bacteria;Bacteria_none;Actinomycetota;Actinomycetes;Micrococcales;Microbacteriaceae;Agrococcus;Agrococcus sp. SCSIO52902	0	1	0	0	0	1	0	0	2
Bacteria;Bacteria_none;Pseudomonadota;Deltaproteobacteria;Myxococcales;Myxococcaceae;Pyxidicoccus;Pyxidicoccus sp. SCPEA002	0	0	0	0	0	1	1	0	2
Bacteria;Bacteria_none;Bacteroidota;Bacteroidia;Bacteroidales;Bacteroidaceae;Bacteroides;Bacteroides salyersiae	0	0	0	0	0	0	1	1	2
Bacteria;Bacteria_none;Actinomycetota;Actinomycetes;Mycobacteriales;Corynebacteriaceae;Corynebacterium;Corynebacterium kroppenstedtii	0	0	0	0	1	0	1	0	2
Bacteria;Bacteria_none;Bacteroidota;Cytophagia;Cytophagales;Fulvivirgaceae;Fulvivirga;Fulvivirga sp. SW1-E11	0	0	0	0	0	0	0	2	2
Bacteria;Bacteria_none;Actinomycetota;Actinomycetes;Mycobacteriales;Corynebacteriaceae;Corynebacterium;Corynebacterium jeikeium	0	0	0	0	0	0	1	1	2
Bacteria;Bacteria_none;Pseudomonadota;Deltaproteobacteria;Desulfovibrionales;Desulfovibrionaceae;Megalodesulfovibrio;Megalodesulfovibrio gigas	0	0	0	0	2	0	0	0	2
Bacteria;Bacteria_none;Actinomycetota;Actinomycetes;Mycobacteriales;Corynebacteriaceae;Corynebacterium;Corynebacterium freneyi	0	0	1	0	0	0	1	0	2
Bacteria;Bacteria_none;Bacteroidota;Bacteroidia;Bacteroidales;Porphyromonadaceae;Porphyromonas;Porphyromonas crevioricanis	0	0	0	1	0	0	0	1	2
Bacteria;Bacteria_none;Pseudomonadota;Gammaproteobacteria;Alteromonadales;Alteromonadaceae;Catenovulum;Catenovulum sediminis	0	0	0	0	0	0	0	2	2
Bacteria;Bacteria_none;Actinomycetota;Actinomycetes;Mycobacteriales;Corynebacteriaceae;Corynebacterium;Corynebacterium callunae	0	0	0	0	0	0	0	2	2
Bacteria;Bacteria_none;Bacteroidota;Bacteroidia;Bacteroidales;Prevotellaceae;Paraprevotella;Paraprevotella xylaniphila	0	0	0	1	0	0	0	1	2
Bacteria;Bacteria_none;Bacteroidota;Cytophagia;Cytophagales;Cyclobacteriaceae;Algoriphagus;Algoriphagus sanaruensis	0	0	0	1	0	0	0	1	2
Bacteria;Bacteria_none;Pseudomonadota;Gammaproteobacteria;Aeromonadales;Aeromonadaceae;Aeromonas;Aeromonas caviae	0	0	0	0	0	0	0	2	2
Bacteria;Bacteria_none;Pseudomonadota;Deltaproteobacteria;Myxococcales;Myxococcaceae;Corallococcus;Corallococcus sp. NCRR	0	0	0	0	1	1	0	0	2
Bacteria;Bacteria_none;Bacteroidota;Chitinophagia;Chitinophagales;Chitinophagaceae;Niabella;Niabella soli	0	0	0	2	0	0	0	0	2
Bacteria;Bacteria_none;Bacteroidota;Flavobacteriia;Flavobacteriales;Flavobacteriaceae;Lacinutrix;Lacinutrix sp. Bg11-31	0	0	0	0	0	0	0	2	2
Bacteria;Bacteria_none;Pseudomonadota;Epsilonproteobacteria;Campylobacterales;Helicobacteraceae;Helicobacter;Helicobacter acinonychis	0	0	0	0	0	0	0	2	2
Bacteria;Bacteria_none;Pseudomonadota;Epsilonproteobacteria;Campylobacterales;Campylobacteraceae;Campylobacter;Campylobacter volucris	0	0	0	0	0	0	0	2	2
Bacteria;Bacteria_none;Pseudomonadota;Epsilonproteobacteria;Campylobacterales;Campylobacteraceae;Campylobacter;Campylobacter upsaliensis	0	0	0	0	0	1	1	0	2
Bacteria;Bacteria_none;Pseudomonadota;Epsilonproteobacteria;Campylobacterales;Campylobacteraceae;Campylobacter;Campylobacter sputorum	0	0	0	0	2	0	0	0	2
Bacteria;Bacteria_none;Pseudomonadota;Deltaproteobacteria;Myxococcales;Sandaracinaceae;Sandaracinus;Sandaracinus amylolyticus	0	0	0	0	1	0	0	1	2
Bacteria;Bacteria_none;Bacteroidota;Bacteroidia;Bacteroidales;Prevotellaceae;Prevotella;Prevotella ruminicola	0	0	0	0	0	0	0	2	2
Bacteria;Bacteria_none;Pseudomonadota;Epsilonproteobacteria;Campylobacterales;Arcobacteraceae;Aliarcobacter;Aliarcobacter butzleri	0	0	0	0	0	0	0	2	2
Bacteria;Bacteria_none;Bacteroidota;Bacteroidia;Bacteroidales;Prevotellaceae;Prevotella;Prevotella sp. E15-22	0	0	0	1	0	0	0	1	2
Bacteria;Bacteria_none;Bacteroidota;Bacteroidia;Bacteroidales;Prevotellaceae;Prevotella;Prevotella sp. E9-3	0	0	0	1	0	0	0	1	2
Bacteria;Bacteria_none;Bacteroidota;Bacteroidia;Marinilabiliales;Prolixibacteraceae;Draconibacterium;Draconibacterium halophilum	0	0	0	0	0	0	0	2	2
Bacteria;Bacteria_none;Bacteroidota;Bacteroidia;Marinilabiliales;Marinifilaceae;Labilibaculum;Labilibaculum antarcticum	0	0	0	1	0	1	0	0	2
Bacteria;Bacteria_none;Actinomycetota;Actinomycetes;Micrococcales;Microbacteriaceae;Microbacterium;Microbacterium sp. nov. GSS16	0	0	0	0	0	0	2	0	2
Bacteria;Bacteria_none;Bacteroidota;Bacteroidia;Bacteroidales;Tannerellaceae;Parabacteroides;Parabacteroides merdae	0	0	0	1	0	0	0	1	2
Bacteria;Bacteria_none;Actinomycetota;Actinomycetes;Mycobacteriales;Corynebacteriaceae;Corynebacterium;Corynebacterium provencense	0	0	0	0	0	0	0	2	2
Bacteria;Bacteria_none;Pseudomonadota;Gammaproteobacteria;Alteromonadales;Pseudoalteromonadaceae;Pseudoalteromonas;Pseudoalteromonas piratica	0	0	0	1	0	1	0	0	2
Bacteria;Bacteria_none;Bacillota;Tissierellia;Tissierellales;Peptoniphilaceae;Peptoniphilus;Peptoniphilus asaccharolyticus	0	0	0	0	0	0	0	2	2
Bacteria;Bacteria_none;Pseudomonadota;Gammaproteobacteria;Alteromonadales;Shewanellaceae;Shewanella;Shewanella sp. NFH-SH190041	0	0	0	0	0	0	0	2	2
Bacteria;Bacteria_none;Actinomycetota;Actinomycetes;Streptosporangiales;Thermomonosporaceae;Actinomadura;Actinomadura sp. WMMB 499	0	0	0	0	0	1	0	1	2
Bacteria;Bacteria_none;Bacteroidota;Flavobacteriia;Flavobacteriales;Flavobacteriaceae;Flavobacterium;Flavobacterium sp. N502540	0	0	0	0	0	0	0	2	2
Bacteria;Bacteria_none;Pseudomonadota;Gammaproteobacteria;Enterobacterales;Morganellaceae;Providencia;Providencia sp. R33	0	0	0	0	2	0	0	0	2
Bacteria;Bacteria_none;Bacillota;Clostridia;Eubacteriales;Peptostreptococcaceae;Clostridioides;Clostridioides difficile	0	0	0	0	0	0	0	2	2
Bacteria;Bacteria_none;Actinomycetota;Actinomycetes;Bifidobacteriales;Bifidobacteriaceae;Bifidobacterium;Bifidobacterium pseudolongum	0	0	0	1	0	0	0	1	2
Bacteria;Bacteria_none;Bacteroidota;Flavobacteriia;Flavobacteriales;Flavobacteriaceae;Flavobacterium;Flavobacterium sp. KACC 22763	0	0	0	0	0	0	0	2	2
Bacteria;Bacteria_none;Actinomycetota;Actinomycetes;Micrococcales;Microbacteriaceae;Curtobacterium;Curtobacterium luteum	0	0	0	0	0	2	0	0	2
Bacteria;Bacteria_none;Bacteroidota;Flavobacteriia;Flavobacteriales;Flavobacteriaceae;Flavobacterium;Flavobacterium sp. IMCC36791	0	0	0	0	1	0	1	0	2
Bacteria;Bacteria_none;Bacillota;Clostridia;Eubacteriales;Peptostreptococcaceae;Terrisporobacter;Terrisporobacter hibernicus	0	0	0	2	0	0	0	0	2
Bacteria;Bacteria_none;Pseudomonadota;Gammaproteobacteria;Enterobacterales;Erwiniaceae;Erwinia;Candidatus Erwinia haradaeae	0	0	0	0	0	0	0	2	2
Bacteria;Bacteria_none;Bacillota;Clostridia;Eubacteriales;Vallitaleaceae;Vallitalea;Vallitalea pronyensis	0	0	0	0	2	0	0	0	2
Bacteria;Bacteria_none;Bacillota;Clostridia;Halanaerobiales;Halanaerobiaceae;Halanaerobium;Halanaerobium praevalens	0	0	0	1	0	0	0	1	2
Bacteria;Bacteria_none;Bacillota;Clostridia;Halanaerobiales;Halanaerobiaceae;Iocasia;Iocasia fonsfrigidae	0	0	0	0	0	0	0	2	2
Bacteria;Bacteria_none;Bacteroidota;Flavobacteriia;Flavobacteriales;Flavobacteriaceae;Flavobacterium;Flavobacterium nitrogenifigens	0	0	0	0	0	0	0	2	2
Bacteria;Bacteria_none;Bacillota;Clostridia;Thermoanaerobacterales;Thermoanaerobacterales Family III. Incertae Sedis;Thermoanaerobacterium;Thermoanaerobacterium xylanolyticum	0	0	0	0	0	0	2	0	2
Bacteria;Bacteria_none;Bacteroidota;Flavobacteriia;Flavobacteriales;Flavobacteriaceae;Flavobacterium;Flavobacterium crocinum	0	0	0	0	0	0	2	0	2
Bacteria;Bacteria_none;Pseudomonadota;Gammaproteobacteria;Enterobacterales;Enterobacteriaceae;Klebsiella;Klebsiella michiganensis	0	0	0	0	0	0	2	0	2
Bacteria;Bacteria_none;Bacteroidota;Flavobacteriia;Flavobacteriales;Flavobacteriaceae;Flavobacterium;Flavobacterium azooxidireducens	0	0	0	0	0	1	0	1	2
Bacteria;Bacteria_none;Bacteroidota;Flavobacteriia;Flavobacteriales;Flavobacteriaceae;Flavivirga;Flavivirga eckloniae	0	0	0	0	0	0	0	2	2
Bacteria;Bacteria_none;Bacteroidota;Flavobacteriia;Flavobacteriales;Flavobacteriaceae;Changchengzhania;Changchengzhania lutea	0	0	1	1	0	0	0	0	2
Bacteria;Bacteria_none;Pseudomonadota;Betaproteobacteria;Burkholderiales;Oxalobacteraceae;Massilia;Massilia sp. NP310	1	0	0	0	0	0	1	0	2
Bacteria;Bacteria_none;Actinomycetota;Actinomycetes;Mycobacteriales;Mycobacteriaceae;Mycobacterium;Mycobacterium rufum	0	0	0	0	1	0	1	0	2
Bacteria;Bacteria_none;Bacteroidota;Flavobacteriia;Flavobacteriales;Flavobacteriaceae;Aquimarina;Aquimarina sp. TRL1	0	0	0	0	0	1	0	1	2
Bacteria;Bacteria_none;Bacillota;Negativicutes;Veillonellales;Veillonellaceae;Veillonella;Veillonella parvula	0	0	0	0	1	1	0	0	2
Bacteria;Bacteria_none;Bacillota;Negativicutes;Veillonellales;Veillonellaceae;Veillonella;Veillonella sp. S12025-13	0	0	0	2	0	0	0	0	2
Bacteria;Bacteria_none;Bacillota;Tissierellia;Tissierellales;Gottschalkiaceae;Gottschalkia;Gottschalkia acidurici	0	0	0	0	0	0	1	1	2
Bacteria;Bacteria_none;Bacillota;Tissierellia;Tissierellales;Peptoniphilaceae;Anaerococcus;Anaerococcus vaginalis	0	0	0	0	0	1	1	0	2
Bacteria;Bacteria_none;Pseudomonadota;Gammaproteobacteria;Legionellales;Coxiellaceae;Rickettsiella;Candidatus Rickettsiella viridis	0	0	0	0	0	0	0	2	2
Bacteria;Bacteria_none;Bacteroidota;Bacteroidia;Bacteroidales;Salinivirgaceae;Salinivirga;Salinivirga cyanobacteriivorans	0	0	0	0	0	0	0	2	2
Bacteria;Bacteria_none;Pseudomonadota;Alphaproteobacteria;Hyphomicrobiales;Rhizobiaceae;Rhizobium;Rhizobium leguminosarum	0	0	0	1	0	0	0	1	2
Bacteria;Bacteria_none;Bacillota;Bacilli;Bacillales;Bacillaceae;Virgibacillus;Virgibacillus sp. Bac332	0	0	0	0	0	0	2	0	2
Bacteria;Bacteria_none;Bacillota;Bacilli;Bacillales;Staphylococcaceae;Staphylococcus;Staphylococcus hominis	0	0	0	0	0	0	1	1	2
Archaea;Archaea_none;Euryarchaeota;Halobacteria;Natrialbales;Natrialbaceae;Natribaculum;Natribaculum sp. CGA3	0	0	0	0	2	0	0	0	2
Eukaryota;Eukaryota_Incertae_sedis;Apicomplexa;Aconoidasida;Haemosporida;Plasmodiidae;Plasmodium;Plasmodium yoelii	0	0	0	0	0	0	1	1	2
Bacteria;Bacteria_none;Pseudomonadota;Alphaproteobacteria;Hyphomicrobiales;Phyllobacteriaceae;Mesorhizobium;Mesorhizobium sp. INR15	0	0	0	0	1	0	1	0	2
Eukaryota;Eukaryota_Incertae_sedis;Apicomplexa;Aconoidasida;Haemosporida;Plasmodiidae;Plasmodium;Plasmodium sp. gorilla clade G2	0	1	1	0	0	0	0	0	2
Eukaryota;Eukaryota_Incertae_sedis;Apicomplexa;Aconoidasida;Haemosporida;Plasmodiidae;Plasmodium;Plasmodium reichenowi	0	0	0	0	0	2	0	0	2
Bacteria;Bacteria_none;Bacillota;Bacilli;Bacillales;Bacillaceae;Bacillus;Bacillus cereus	0	0	0	0	0	0	0	2	2
Eukaryota;Eukaryota_Incertae_sedis;Apicomplexa;Aconoidasida;Haemosporida;Plasmodiidae;Plasmodium;Plasmodium malariae	0	0	0	1	0	0	0	1	2
Eukaryota;Eukaryota_Incertae_sedis;Apicomplexa;Aconoidasida;Haemosporida;Plasmodiidae;Plasmodium;Plasmodium berghei	0	0	0	0	0	1	0	1	2
Bacteria;Bacteria_none;Bacillota;Bacilli;Lactobacillales;Enterococcaceae;Enterococcus;Enterococcus faecalis	0	1	0	0	0	1	0	0	2
Bacteria;Bacteria_none;Actinomycetota;Actinomycetes;Kitasatosporales;Streptomycetaceae;Streptomyces;Streptomyces sp. SM18	0	0	1	0	0	1	0	0	2
Bacteria;Bacteria_none;Mycoplasmatota;Mollicutes;Entomoplasmatales;Entomoplasmataceae;Mesoplasma;Mesoplasma florum	0	0	0	0	0	0	0	2	2
Eukaryota;Fungi;Ascomycota;Sordariomycetes;Hypocreales;Nectriaceae;Fusarium;Fusarium oxysporum	0	0	0	0	0	0	1	1	2
Bacteria;Bacteria_none;Bacillota;Bacilli;Lactobacillales;Enterococcaceae;Enterococcus;Enterococcus saigonensis	0	0	0	1	0	0	1	0	2
Bacteria;Bacteria_none;Bacillota;Bacilli;Bacillales;Listeriaceae;Listeria;Listeria marthii	0	1	1	0	0	0	0	0	2
Eukaryota;Fungi;Ascomycota;Sordariomycetes;Hypocreales;Ophiocordycipitaceae;Purpureocillium;Purpureocillium takamizusanense	0	1	0	0	1	0	0	0	2
Bacteria;Bacteria_none;Bacillota;Bacilli;Lactobacillales;Lactobacillaceae;Companilactobacillus;Companilactobacillus paralimentarius	0	0	0	0	2	0	0	0	2
Bacteria;Bacteria_none;Pseudomonadota;Alphaproteobacteria;Hyphomicrobiales;Blastochloridaceae;Blastochloris;Blastochloris tepida	0	0	0	1	0	0	0	1	2
Bacteria;Bacteria_none;Spirochaetota;Spirochaetia;Spirochaetales;Treponemataceae;Treponema;Treponema phagedenis	0	1	0	0	0	0	0	1	2
Bacteria;Bacteria_none;Bacillota;Bacilli;Lactobacillales;Lactobacillaceae;Lacticaseibacillus;Lacticaseibacillus paracasei	0	0	0	0	2	0	0	0	2
Bacteria;Bacteria_none;Bacillota;Bacilli;Bacillales;Bacillaceae;Bacillus;Bacillus weihaiensis	0	0	0	0	0	0	0	2	2
Bacteria;Bacteria_none;Bacillota;Bacilli;Bacillales;Paenibacillaceae;Cohnella;Cohnella abietis	0	0	0	0	0	0	0	2	2
Eukaryota;Eukaryota_Incertae_sedis;Apicomplexa;Aconoidasida;Piroplasmida;Babesiidae;Babesia;Babesia microti	0	0	0	0	0	0	2	0	2
Bacteria;Bacteria_none;Pseudomonadota;Alphaproteobacteria;Hyphomicrobiales;Nitrobacteraceae;Bradyrhizobium;Bradyrhizobium sp. CCBAU 53421	0	0	0	0	0	0	0	2	2
Eukaryota;Eukaryota_Incertae_sedis;Parabasalia;Parabasalia_Incertae_sedis;Trichomonadida;Trichomonadidae;Trichomonas;Trichomonas vaginalis	0	0	0	0	0	0	1	1	2
Bacteria;Bacteria_none;Bacillota;Bacilli;Bacillales;Paenibacillaceae;Paenibacillus;Paenibacillus sp. 481	0	0	0	0	0	0	2	0	2
Eukaryota;Fungi;Ascomycota;Saccharomycetes;Saccharomycetales;Phaffomycetaceae;Komagataella;Komagataella phaffii	0	0	0	0	0	0	1	1	2
Eukaryota;Fungi;Ascomycota;Saccharomycetes;Saccharomycetales;Debaryomycetaceae;Candida;Candida dubliniensis	0	1	0	0	0	0	0	1	2
Eukaryota;Fungi;Ascomycota;Saccharomycetes;Saccharomycetales;Pichiaceae;Brettanomyces;Brettanomyces nanus	0	1	0	0	1	0	0	0	2
Bacteria;Bacteria_none;Bacillota;Bacilli;Bacillales;Paenibacillaceae;Paenibacillus;Paenibacillus sp. PHS-Z3	0	0	0	0	0	0	0	2	2
Eukaryota;Fungi;Ascomycota;Eurotiomycetes;Eurotiales;Aspergillaceae;Aspergillus;Aspergillus nidulans	0	0	0	0	0	0	0	2	2
Eukaryota;Fungi;Ascomycota;Eurotiomycetes;Eurotiales;Aspergillaceae;Aspergillus;Aspergillus luchuensis	0	1	0	0	0	0	0	1	2
Eukaryota;Fungi;Ascomycota;Eurotiomycetes;Eurotiales;Aspergillaceae;Aspergillus;Aspergillus chevalieri	0	0	0	1	0	0	1	0	2
Eukaryota;Fungi;Ascomycota;Sordariomycetes;Glomerellales;Glomerellaceae;Colletotrichum;Colletotrichum higginsianum	0	0	0	1	0	1	0	0	2
Bacteria;Bacteria_none;Fusobacteriota;Fusobacteriia;Fusobacteriales;Leptotrichiaceae;Leptotrichia;Leptotrichia sp. oral taxon 212	0	0	0	0	0	0	0	2	2
Bacteria;Bacteria_none;Fusobacteriota;Fusobacteriia;Fusobacteriales;Fusobacteriaceae;Fusobacterium;Fusobacterium mortiferum	1	0	0	0	0	0	0	1	2
Bacteria;Bacteria_none;Actinomycetota;Actinomycetes;Kitasatosporales;Streptomycetaceae;Streptomyces;Streptomyces sp. S063	0	0	0	0	0	1	0	1	2
Bacteria;Bacteria_none;Fusobacteriota;Fusobacteriia;Fusobacteriales;Fusobacteriaceae;Fusobacterium;Fusobacterium varium	0	0	0	0	0	0	0	2	2
Eukaryota;Fungi;Ascomycota;Sordariomycetes;Glomerellales;Glomerellaceae;Colletotrichum;Colletotrichum lupini	0	0	0	0	1	0	0	1	2
Bacteria;Bacteria_none;Bacillota;Bacilli;Bacillales;Paenibacillaceae;Paenibacillus;Paenibacillus bovis	1	0	0	0	0	0	1	0	2
Bacteria;Bacteria_none;Fusobacteriota;Fusobacteriia;Fusobacteriales;Fusobacteriaceae;Fusobacterium;Fusobacterium nucleatum	0	0	0	0	0	0	0	2	2
Eukaryota;Eukaryota_Incertae_sedis;Apicomplexa;Conoidasida;Eucoccidiorida;Sarcocystidae;Neospora;Neospora caninum	0	1	0	1	0	0	0	0	2
Eukaryota;Fungi;Ascomycota;Sordariomycetes;Hypocreales;Clavicipitaceae;Ustilaginoidea;Ustilaginoidea virens	0	0	0	0	1	1	0	0	2
Bacteria;Bacteria_none;Bacillota;Bacilli;Bacillales;Bacillaceae;Bacillus;Bacillus shivajii	1	0	0	0	0	0	0	1	2
Bacteria;Bacteria_none;Bacillota;Bacilli;Bacillales;Staphylococcaceae;Staphylococcus;Staphylococcus arlettae	0	0	0	0	0	0	0	2	2
Bacteria;Bacteria_none;Pseudomonadota;Alphaproteobacteria;Hyphomicrobiales;Rhizobiaceae;Rhizobium;Rhizobium sp. NLR16a	0	0	2	0	0	0	0	0	2
Eukaryota;Fungi;Ascomycota;Saccharomycetes;Saccharomycetales;Debaryomycetaceae;Debaryomyces;Debaryomyces hansenii	0	0	0	0	0	2	0	0	2
Bacteria;Bacteria_none;Pseudomonadota;Alphaproteobacteria;Hyphomicrobiales;Stappiaceae;Labrenzia;Labrenzia sp. THAF82	0	0	0	0	0	0	0	2	2
Bacteria;Bacteria_none;Mycoplasmatota;Mollicutes;Mycoplasmatales;Mycoplasmataceae;Mycoplasma;Mycoplasma suis	0	0	0	0	0	1	0	1	2
Bacteria;Bacteria_none;Bacillota;Bacilli;Bacillales;Bacillaceae;Pradoshia;Pradoshia sp. D12	0	0	0	0	0	2	0	0	2
Archaea;Archaea_none;Euryarchaeota;Halobacteria;Halobacteriales;Haloarculaceae;Halomicrobium;Halomicrobium sp. LC1Hm	0	1	1	0	0	0	0	0	2
Bacteria;Bacteria_none;Actinomycetota;Coriobacteriia;Coriobacteriales;Coriobacteriaceae;Collinsella;Collinsella aerofaciens	0	0	0	0	0	0	0	2	2
Bacteria;Bacteria_none;Bacillota;Bacilli;Lactobacillales;Lactobacillaceae;Lactobacillus;Lactobacillus paragasseri	0	1	0	0	0	1	0	0	2
Bacteria;Bacteria_none;Pseudomonadota;Alphaproteobacteria;Rhodobacterales;Paracoccaceae;Paracoccus;Paracoccus zhejiangensis	0	0	0	0	0	0	0	2	2
Archaea;Archaea_none;Crenarchaeota;Thermoprotei;Thermofilales;Thermofilaceae;Thermofilum;Thermofilum adornatum	0	0	0	0	0	0	2	0	2
Bacteria;Bacteria_none;Bacillota;Bacilli;Bacillales;Bacillaceae;Lysinibacillus;Lysinibacillus timonensis	0	0	0	1	0	0	0	1	2
Bacteria;Bacteria_none;Bacillota;Bacilli;Lactobacillales;Lactobacillaceae;Lactobacillus;Lactobacillus taiwanensis	0	0	0	0	0	1	1	0	2
Bacteria;Bacteria_none;Pseudomonadota;Gammaproteobacteria;Xanthomonadales;Xanthomonadaceae;Xanthomonas;Xanthomonas campestris	0	1	0	0	0	0	1	0	2
Bacteria;Bacteria_none;Actinomycetota;Actinomycetes;Kitasatosporales;Streptomycetaceae;Streptomyces;Streptomyces venezuelae	0	0	0	0	0	0	0	2	2
Bacteria;Bacteria_none;Bacillota;Bacilli;Bacillales;Bacillaceae;Lysinibacillus;Lysinibacillus sphaericus	0	0	0	1	0	1	0	0	2
Bacteria;Bacteria_none;Actinomycetota;Acidimicrobiia;Acidimicrobiales;Iamiaceae;Iamia;Iamia majanohamensis	0	0	0	1	0	0	1	0	2
Viruses;Orthornavirae;Negarnaviricota;Insthoviricetes;Articulavirales;Orthomyxoviridae;Alphainfluenzavirus;Influenza A virus	0	0	1	0	0	0	1	0	2
Bacteria;Bacteria_none;Pseudomonadota;Gammaproteobacteria;Xanthomonadales;Xanthomonadaceae;Pseudoxanthomonas;Pseudoxanthomonas mexicana	0	0	1	0	0	1	0	0	2
Bacteria;Bacteria_none;Bacillota;Bacilli;Lactobacillales;Lactobacillaceae;Limosilactobacillus;Limosilactobacillus fermentum	0	1	0	0	0	1	0	0	2
Bacteria;Bacteria_none;Bacillota;Bacilli;Lactobacillales;Lactobacillaceae;Limosilactobacillus;Limosilactobacillus frumenti	0	0	0	0	0	2	0	0	2
Bacteria;Bacteria_none;Bacillota;Bacilli;Lactobacillales;Lactobacillaceae;Limosilactobacillus;Limosilactobacillus panis	0	1	0	0	0	1	0	0	2
Eukaryota;Fungi;Basidiomycota;Pucciniomycetes;Pucciniales;Pucciniaceae;Puccinia;Puccinia triticina	0	0	0	0	1	0	0	1	2
Eukaryota;Fungi;Basidiomycota;Tremellomycetes;Tremellales;Cryptococcaceae;Cryptococcus;Cryptococcus neoformans	0	0	0	1	0	0	0	1	2
Bacteria;Bacteria_none;Bacillota;Bacilli;Bacillales;Bacillaceae;Salipaludibacillus;Salipaludibacillus sp. LMS25	0	0	0	0	0	2	0	0	2
Eukaryota;Fungi;Ascomycota;Sordariomycetes;Magnaporthales;Pyriculariaceae;Pyricularia;Pyricularia pennisetigena	0	0	0	0	0	1	0	1	2
Bacteria;Bacteria_none;Pseudomonadota;Alphaproteobacteria;Hyphomicrobiales;Bartonellaceae;Bartonella;Bartonella schoenbuchensis	0	0	0	0	0	0	0	2	2
Bacteria;Bacteria_none;Spirochaetota;Spirochaetia;Brachyspirales;Brachyspiraceae;Brachyspira;Brachyspira hampsonii	0	0	0	1	1	0	0	0	2
Bacteria;Bacteria_none;Actinomycetota;Coriobacteriia;Eggerthellales;Eggerthellaceae;Raoultibacter;Raoultibacter timonensis	0	0	0	1	0	0	0	1	2
Bacteria;Bacteria_none;Cyanobacteriota;Cyanophyceae;Nostocales;Nostocaceae;Nostoc;Nostoc sp. C057	0	0	0	0	0	0	0	2	2
Bacteria;Bacteria_none;Pseudomonadota;Betaproteobacteria;Neisseriales;Chromobacteriaceae;Chromobacterium;Chromobacterium sp. Rain0013	0	0	0	0	0	0	0	1	1
Bacteria;Bacteria_none;Pseudomonadota;Betaproteobacteria;Neisseriales;Chromobacteriaceae;Chromobacterium;Chromobacterium vaccinii	0	0	0	0	0	0	0	1	1
Bacteria;Bacteria_none;Planctomycetota;Planctomycetia;Planctomycetales;Planctomycetaceae;Gimesia;Gimesia chilikensis	0	0	0	0	1	0	0	0	1
Bacteria;Bacteria_none;Pseudomonadota;Epsilonproteobacteria;Campylobacterales;Arcobacteraceae;Aliarcobacter;Aliarcobacter faecis	1	0	0	0	0	0	0	0	1
Bacteria;Bacteria_none;Actinomycetota;Actinomycetes;Kitasatosporales;Streptomycetaceae;Streptomyces;Streptomyces prasinus	0	0	0	0	0	0	0	1	1
Bacteria;Bacteria_none;Pseudomonadota;Deltaproteobacteria;Desulfovibrionales;Desulfovibrionaceae;Pseudodesulfovibrio;Pseudodesulfovibrio cashew	0	0	0	0	0	0	0	1	1
Bacteria;Bacteria_none;Planctomycetota;Planctomycetia;Planctomycetales;Planctomycetaceae;Crateriforma;Crateriforma conspicua	0	0	0	0	1	0	0	0	1
Bacteria;Bacteria_none;Pseudomonadota;Alphaproteobacteria;Hyphomicrobiales;Hyphomicrobiaceae;Rhodoplanes;Rhodoplanes piscinae	0	0	0	0	1	0	0	0	1
Bacteria;Bacteria_none;Pseudomonadota;Betaproteobacteria;Neisseriales;Neisseriaceae;Alysiella;Alysiella crassa	0	1	0	0	0	0	0	0	1
Bacteria;Bacteria_none;Pseudomonadota;Betaproteobacteria;Neisseriales;Neisseriaceae;Kingella;Kingella potus	0	0	0	0	0	0	0	1	1
Bacteria;Bacteria_none;Actinomycetota;Actinomycetes;Kitasatosporales;Streptomycetaceae;Streptomyces;Streptomyces leeuwenhoekii	0	0	0	0	0	1	0	0	1
Bacteria;Bacteria_none;Pseudomonadota;Epsilonproteobacteria;Campylobacterales;Arcobacteraceae;Aliarcobacter;Aliarcobacter thereius	0	0	1	0	0	0	0	0	1
Bacteria;Bacteria_none;Pseudomonadota;Deltaproteobacteria;Desulfobacterales;Desulfocapsaceae;Desulfosediminicola;Desulfosediminicola flagellatus	0	1	0	0	0	0	0	0	1
Bacteria;Bacteria_none;Pseudomonadota;Betaproteobacteria;Neisseriales;Neisseriaceae;Neisseria;Neisseria bacilliformis	0	0	0	0	0	0	0	1	1
Bacteria;Bacteria_none;Pseudomonadota;Alphaproteobacteria;Hyphomicrobiales;Kaistiaceae;Kaistia;Kaistia sp. 32K	0	0	0	0	0	1	0	0	1
Bacteria;Bacteria_none;Pseudomonadota;Betaproteobacteria;Burkholderiales;Sphaerotilaceae;Roseateles;Roseateles depolymerans	0	0	0	0	0	0	0	1	1
Bacteria;Bacteria_none;Planctomycetota;Planctomycetia;Pirellulales;Thermoguttaceae;Thermogutta;Thermogutta terrifontis	0	0	0	0	0	0	1	0	1
Bacteria;Bacteria_none;Pseudomonadota;Betaproteobacteria;Burkholderiales;Oxalobacteraceae;Pseudoduganella;Pseudoduganella plicata	0	0	0	0	0	0	0	1	1
Bacteria;Bacteria_none;Actinomycetota;Actinomycetes;Kitasatosporales;Streptomycetaceae;Streptomyces;Streptomyces incarnatus	0	0	0	0	0	0	0	1	1
Bacteria;Bacteria_none;Pseudomonadota;Deltaproteobacteria;Desulfuromonadales;Geobacteraceae;Geoalkalibacter;Geoalkalibacter subterraneus	0	0	0	0	1	0	0	0	1
Bacteria;Bacteria_none;Pseudomonadota;Betaproteobacteria;Burkholderiales;Oxalobacteraceae;Pseudoduganella;Pseudoduganella flava	0	0	0	0	0	1	0	0	1
Bacteria;Bacteria_none;Pseudomonadota;Alphaproteobacteria;Hyphomicrobiales;Lichenihabitantaceae;Lichenihabitans;Lichenihabitans sp. PAMC28606	0	0	0	0	0	0	1	0	1
Bacteria;Bacteria_none;Pseudomonadota;Epsilonproteobacteria;Campylobacterales;Arcobacteraceae;Arcobacter;Arcobacter acticola	0	0	0	0	0	0	0	1	1
Bacteria;Bacteria_none;Planctomycetota;Planctomycetia;Pirellulales;Pirellulaceae;Roseimaritima;Roseimaritima multifibrata	0	1	0	0	0	0	0	0	1
Bacteria;Bacteria_none;Pseudomonadota;Betaproteobacteria;Burkholderiales;Oxalobacteraceae;Janthinobacterium;Janthinobacterium svalbardensis	0	0	0	0	0	0	0	1	1
Bacteria;Bacteria_none;Pseudomonadota;Deltaproteobacteria;Desulfuromonadales;Geobacteraceae;Geobacter;Geobacter sp. DSM 9736	0	0	0	1	0	0	0	0	1
Bacteria;Bacteria_none;Pseudomonadota;Deltaproteobacteria;Desulfuromonadales;Geobacteraceae;Geobacter;Geobacter benzoatilyticus	0	0	0	0	0	0	0	1	1
Bacteria;Bacteria_none;Pseudomonadota;Deltaproteobacteria;Desulfuromonadales;Geobacteraceae;Geobacter;Geobacter sp. SVR	0	0	0	1	0	0	0	0	1
Bacteria;Bacteria_none;Pseudomonadota;Deltaproteobacteria;Desulfuromonadales;Syntrophotaleaceae;Syntrophotalea;Syntrophotalea acetylenivorans	0	0	0	1	0	0	0	0	1
Bacteria;Bacteria_none;Pseudomonadota;Alphaproteobacteria;Hyphomicrobiales;Bartonellaceae;Bartonella;Bartonella clarridgeiae	0	0	0	0	0	1	0	0	1
Bacteria;Bacteria_none;Actinomycetota;Actinomycetes;Kitasatosporales;Streptomycetaceae;Streptomyces;Streptomyces lincolnensis	0	0	0	0	0	0	1	0	1
Bacteria;Bacteria_none;Pseudomonadota;Deltaproteobacteria;Myxococcales;Archangiaceae;Archangium;Archangium violaceum	0	0	0	0	0	0	1	0	1
Bacteria;Bacteria_none;Pseudomonadota;Alphaproteobacteria;Hyphomicrobiales;Aurantimonadaceae;Aureimonas;Aureimonas populi	0	0	0	0	0	0	1	0	1
Bacteria;Bacteria_none;Pseudomonadota;Deltaproteobacteria;Desulfobacterales;Desulfobulbaceae;Desulfobulbus;Desulfobulbus propionicus	0	0	0	0	0	0	0	1	1
Bacteria;Bacteria_none;Pseudomonadota;Deltaproteobacteria;Myxococcales;Myxococcaceae;Myxococcus;Myxococcus xanthus	1	0	0	0	0	0	0	0	1
Bacteria;Bacteria_none;Pseudomonadota;Deltaproteobacteria;Desulfobacterales;Desulfobulbaceae;Desulfobulbus;Desulfobulbus oralis	0	0	0	0	0	0	0	1	1
Bacteria;Bacteria_none;Pseudomonadota;Deltaproteobacteria;Desulfobacterales;Desulfobacteraceae;Desulfonema;Desulfonema limicola	0	0	0	0	0	0	0	1	1
Bacteria;Bacteria_none;Pseudomonadota;Deltaproteobacteria;Desulfobacterales;Desulfobacteraceae;Desulfatibacillum;Desulfatibacillum aliphaticivorans	0	0	0	0	0	0	0	1	1
Bacteria;Bacteria_none;Pseudomonadota;Betaproteobacteria;Rhodocyclales;Azonexaceae;Quatrionicoccus;Quatrionicoccus australiensis	0	0	0	0	0	0	0	1	1
Bacteria;Bacteria_none;Pseudomonadota;Betaproteobacteria;Nitrosomonadales;Sterolibacteriaceae;Sulfuritalea;Sulfuritalea hydrogenivorans	0	0	0	0	0	1	0	0	1
Bacteria;Bacteria_none;Pseudomonadota;Alphaproteobacteria;Holosporales;Holosporaceae;Candidatus Cytomitobacter;Candidatus Cytomitobacter primus	0	1	0	0	0	0	0	0	1
Bacteria;Bacteria_none;Pseudomonadota;Betaproteobacteria;Burkholderiales;Comamonadaceae;Variovorax;Variovorax sp. PAMC26660	0	0	1	0	0	0	0	0	1
Bacteria;Bacteria_none;Pseudomonadota;Betaproteobacteria;Nitrosomonadales;Sterolibacteriaceae;Methyloversatilis;Methyloversatilis sp. RAC08	0	0	1	0	0	0	0	0	1
Bacteria;Bacteria_none;Pseudomonadota;Deltaproteobacteria;Desulfobacterales;Desulfocapsaceae;Desulfotalea;Desulfotalea psychrophila	0	0	0	0	1	0	0	0	1
Bacteria;Bacteria_none;Pseudomonadota;Deltaproteobacteria;Myxococcales;Nannocystaceae;Nannocystis;Nannocystis sp. fl3	0	0	0	0	0	0	0	1	1
Bacteria;Bacteria_none;Pseudomonadota;Alphaproteobacteria;Hyphomicrobiales;Devosiaceae;Devosia;Devosia ginsengisoli	0	0	0	1	0	0	0	0	1
Bacteria;Bacteria_none;Pseudomonadota;Betaproteobacteria;Nitrosomonadales;Methylophilaceae;Candidatus Methylopumilus;Candidatus Methylopumilus planktonicus	0	1	0	0	0	0	0	0	1
Bacteria;Bacteria_none;Pseudomonadota;Betaproteobacteria;Neisseriales;Neisseriaceae;Neisseria;Neisseria weixii	0	0	0	0	0	0	0	1	1
Bacteria;Bacteria_none;Pseudomonadota;Deltaproteobacteria;Desulfovibrionales;Desulfovibrionaceae;Desulfovibrio;Desulfovibrio fairfieldensis	0	0	0	0	0	1	0	0	1
Bacteria;Bacteria_none;Pseudomonadota;Alphaproteobacteria;Hyphomicrobiales;Bartonellaceae;Bartonella;Bartonella vinsonii	0	0	0	0	0	0	1	0	1
Bacteria;Bacteria_none;Pseudomonadota;Betaproteobacteria;Neisseriales;Neisseriaceae;Neisseria;Neisseria mucosa	0	1	0	0	0	0	0	0	1
Bacteria;Bacteria_none;Pseudomonadota;Alphaproteobacteria;Emcibacterales;Emcibacteraceae;Pseudemcibacter;Pseudemcibacter aquimaris	0	0	0	0	0	1	0	0	1
Bacteria;Bacteria_none;Pseudomonadota;Alphaproteobacteria;Emcibacterales;Emcibacteraceae;Luteithermobacter;Luteithermobacter gelatinilyticus	0	0	0	0	1	0	0	0	1
Bacteria;Bacteria_none;Pseudomonadota;Alphaproteobacteria;Hyphomicrobiales;Chelatococcaceae;Chelatococcus;Chelatococcus sp. CO-6	0	0	0	0	0	0	1	0	1
Bacteria;Bacteria_none;Actinomycetota;Actinomycetes;Kitasatosporales;Streptomycetaceae;Streptomyces;Streptomyces niveus	0	0	0	0	0	1	0	0	1
Bacteria;Bacteria_none;Pseudomonadota;Alphaproteobacteria;Hyphomicrobiales;Boseaceae;Bosea;Bosea sp. Tri-49	0	0	0	0	0	0	0	1	1
Bacteria;Bacteria_none;Pseudomonadota;Alphaproteobacteria;Caulobacterales;Caulobacteraceae;Brevundimonas;Brevundimonas subvibrioides	0	0	0	0	0	1	0	0	1
Bacteria;Bacteria_none;Actinomycetota;Actinomycetes;Kitasatosporales;Streptomycetaceae;Streptomyces;Streptomyces nodosus	0	0	0	0	0	1	0	0	1
Bacteria;Bacteria_none;Planctomycetota;Planctomycetia;Planctomycetales;Planctomycetaceae;Thalassoglobus;Thalassoglobus polymorphus	0	1	0	0	0	0	0	0	1
Bacteria;Bacteria_none;Pseudomonadota;Alphaproteobacteria;Rhodobacterales;Roseobacteraceae;Leisingera;Leisingera sp. M523	0	0	0	0	0	0	0	1	1
Bacteria;Bacteria_none;Pseudomonadota;Betaproteobacteria;Burkholderiales;Comamonadaceae;Comamonas;Comamonas aquatica	0	0	1	0	0	0	0	0	1
Bacteria;Bacteria_none;Pseudomonadota;Betaproteobacteria;Burkholderiales;Comamonadaceae;Variovorax;Variovorax paradoxus	0	1	0	0	0	0	0	0	1
Bacteria;Bacteria_none;Pseudomonadota;Alphaproteobacteria;Hyphomonadales;Hyphomonadaceae;Candidatus Viadribacter;Candidatus Viadribacter manganicus	0	0	0	0	0	1	0	0	1
Bacteria;Bacteria_none;Pseudomonadota;Alphaproteobacteria;Rhodobacterales;Paracoccaceae;Paracoccus;Paracoccus sanguinis	0	0	0	0	0	0	1	0	1
Bacteria;Bacteria_none;Pseudomonadota;Alphaproteobacteria;Sphingomonadales;Sphingomonadaceae;Sphingomonas;Sphingomonas sp. HMP9	0	0	0	0	0	0	0	1	1
Bacteria;Bacteria_none;Pseudomonadota;Alphaproteobacteria;Sphingomonadales;Sphingomonadaceae;Sphingopyxis;Sphingopyxis sp. YF1	0	0	0	0	0	1	0	0	1
Bacteria;Bacteria_none;Pseudomonadota;Alphaproteobacteria;Rhodobacterales;Paracoccaceae;Paracoccus;Paracoccus contaminans	0	0	0	0	0	1	0	0	1
Bacteria;Bacteria_none;Pseudomonadota;Alphaproteobacteria;Hyphomonadales;Hyphomonadaceae;Hyphomonas;Hyphomonas sp. CACIAM 19H1	0	0	0	0	0	0	0	1	1
Bacteria;Bacteria_none;Pseudomonadota;Betaproteobacteria;Burkholderiales;Alcaligenaceae;Achromobacter;Achromobacter spanius	0	0	0	0	0	0	0	1	1
Bacteria;Bacteria_none;Pseudomonadota;Alphaproteobacteria;Hyphomonadales;Hyphomonadaceae;Hyphomonas;Hyphomonas atlantica	0	0	0	0	0	0	0	1	1
Bacteria;Bacteria_none;Pseudomonadota;Epsilonproteobacteria;Campylobacterales;Arcobacteraceae;Halarcobacter;Halarcobacter bivalviorum	0	0	0	0	0	0	1	0	1
Bacteria;Bacteria_none;Pseudomonadota;Alphaproteobacteria;Hyphomicrobiales;Stappiaceae;Roseibium;Roseibium aggregatum	0	0	0	0	1	0	0	0	1
Bacteria;Bacteria_none;Pseudomonadota;Alphaproteobacteria;Sphingomonadales;Sphingomonadaceae;Sphingomonas;Sphingomonas morindae	0	0	0	0	1	0	0	0	1
Bacteria;Bacteria_none;Pseudomonadota;Betaproteobacteria;Burkholderiales;Alcaligenaceae;Basilea;Basilea psittacipulmonis	0	0	0	1	0	0	0	0	1
Bacteria;Bacteria_none;Pseudomonadota;Alphaproteobacteria;Hyphomicrobiales;Rhizobiaceae;Rhizobium;Rhizobium sp. Pop5	0	0	0	0	0	0	0	1	1
Bacteria;Bacteria_none;Pseudomonadota;Betaproteobacteria;Burkholderiales;Alcaligenaceae;Bordetella;Bordetella bronchiseptica	0	0	0	0	0	0	1	0	1
Bacteria;Bacteria_none;Pseudomonadota;Alphaproteobacteria;Hyphomicrobiales;Rhizobiaceae;Rhizobium;Rhizobium sp. ACO-34A	0	0	0	0	0	0	1	0	1
Bacteria;Bacteria_none;Pseudomonadota;Betaproteobacteria;Burkholderiales;Alcaligenaceae;Bordetella;Bordetella sp. N	0	0	0	0	0	1	0	0	1
Bacteria;Bacteria_none;Pseudomonadota;Betaproteobacteria;Burkholderiales;Alcaligenaceae;Orrella;Orrella sp. f23	0	0	1	0	0	0	0	0	1
Bacteria;Bacteria_none;Pseudomonadota;Betaproteobacteria;Burkholderiales;Alcaligenaceae;Pusillimonas;Pusillimonas sp. DMV24BSW_D	0	0	0	0	0	1	0	0	1
Bacteria;Bacteria_none;Pseudomonadota;Alphaproteobacteria;Hyphomicrobiales;Rhizobiaceae;Rhizobium;Rhizobium pseudoryzae	0	0	0	0	0	0	0	1	1
Bacteria;Bacteria_none;Pseudomonadota;Alphaproteobacteria;Sphingomonadales;Sphingomonadaceae;Sphingomonas;Sphingomonas sp. HMP6	0	0	0	0	0	0	0	1	1
Bacteria;Bacteria_none;Pseudomonadota;Alphaproteobacteria;Sphingomonadales;Sphingomonadaceae;Sphingomonas;Sphingomonas melonis	0	0	0	0	0	0	1	0	1
Bacteria;Bacteria_none;Pseudomonadota;Betaproteobacteria;Burkholderiales;Burkholderiaceae;Burkholderia;Burkholderia pyrrocinia	0	0	1	0	0	0	0	0	1
Bacteria;Bacteria_none;Pseudomonadota;Alphaproteobacteria;Rickettsiales;Anaplasmataceae;Ehrlichia;Ehrlichia canis	0	0	0	0	0	0	0	1	1
Bacteria;Bacteria_none;Pseudomonadota;Alphaproteobacteria;Rhodobacterales;Roseobacteraceae;Octadecabacter;Octadecabacter sp. SW4	0	0	0	0	0	0	0	1	1
Bacteria;Bacteria_none;Pseudomonadota;Alphaproteobacteria;Rhodobacterales;Roseobacteraceae;Ponticoccus;Ponticoccus alexandrii	0	0	1	0	0	0	0	0	1
Bacteria;Bacteria_none;Pseudomonadota;Alphaproteobacteria;Rhodobacterales;Roseobacteraceae;Salipiger;Salipiger abyssi	0	0	0	0	0	1	0	0	1
Bacteria;Bacteria_none;Pseudomonadota;Alphaproteobacteria;Rhodobacterales;Roseobacteraceae;Thalassobacter;Thalassobacter stenotrophicus	0	0	0	0	0	0	0	1	1
Bacteria;Bacteria_none;Pseudomonadota;Alphaproteobacteria;Rhodobacterales;Roseobacteraceae;Yangia;Yangia pacifica	0	0	0	0	0	0	1	0	1
Bacteria;Bacteria_none;Pseudomonadota;Alphaproteobacteria;Rhodospirillales;Azospirillaceae;Skermanella;Skermanella pratensis	0	1	0	0	0	0	0	0	1
Bacteria;Bacteria_none;Pseudomonadota;Alphaproteobacteria;Rhodospirillales;Geminicoccaceae;Tistrella;Tistrella mobilis	0	0	0	0	0	0	1	0	1
Bacteria;Bacteria_none;Pseudomonadota;Alphaproteobacteria;Rhodobacterales;Paracoccaceae;Rhodophyticola;Rhodophyticola sp. CCM32	1	0	0	0	0	0	0	0	1
Bacteria;Bacteria_none;Pseudomonadota;Alphaproteobacteria;Rickettsiales;Candidatus Midichloriaceae;Candidatus Midichloria;Candidatus Midichloria mitochondrii	0	0	0	0	0	0	0	1	1
Bacteria;Bacteria_none;Pseudomonadota;Alphaproteobacteria;Sphingomonadales;Sphingomonadaceae;Sphingomonas;Sphingomonas aliaeris	0	0	0	0	0	1	0	0	1
Bacteria;Bacteria_none;Pseudomonadota;Alphaproteobacteria;Rickettsiales;Rickettsiaceae;Rickettsia;Rickettsia prowazekii	0	0	0	1	0	0	0	0	1
Bacteria;Bacteria_none;Pseudomonadota;Alphaproteobacteria;Rhodobacterales;Paracoccaceae;Qingshengfaniella;Qingshengfaniella alkalisoli	1	0	0	0	0	0	0	0	1
Bacteria;Bacteria_none;Pseudomonadota;Alphaproteobacteria;Rickettsiales;Rickettsiales_Incertae_sedis;Rickettsiales_Incertae_sedis_Incertae_sedis;Rickettsiales endosymbiont of Stachyamoeba lipophora	0	0	0	0	0	0	0	1	1
Bacteria;Bacteria_none;Pseudomonadota;Alphaproteobacteria;Sphingomonadales;Erythrobacteraceae;Tsuneonella;Tsuneonella flava	0	0	0	0	0	1	0	0	1
Bacteria;Bacteria_none;Actinomycetota;Actinomycetes;Kitasatosporales;Streptomycetaceae;Streptomyces;Streptomyces sp. DSM 40868	0	0	1	0	0	0	0	0	1
Bacteria;Bacteria_none;Pseudomonadota;Alphaproteobacteria;Rhodobacterales;Paracoccaceae;Paracoccus;Paracoccus sp. MC1862	1	0	0	0	0	0	0	0	1
Bacteria;Bacteria_none;Pseudomonadota;Alphaproteobacteria;Sphingomonadales;Sphingomonadaceae;Blastomonas;Blastomonas sp. RAC04	0	0	0	0	0	1	0	0	1
Bacteria;Bacteria_none;Pseudomonadota;Alphaproteobacteria;Sphingomonadales;Sphingomonadaceae;Novosphingobium;Novosphingobium sp. P6W	0	0	0	1	0	0	0	0	1
Bacteria;Bacteria_none;Pseudomonadota;Betaproteobacteria;Burkholderiales;Burkholderiaceae;Burkholderia;Burkholderia gladioli	0	0	0	0	1	0	0	0	1
Bacteria;Bacteria_none;Pseudomonadota;Betaproteobacteria;Burkholderiales;Burkholderiaceae;Burkholderia;Burkholderia sp. PAMC 26561	0	0	0	0	0	1	0	0	1
Bacteria;Bacteria_none;Actinomycetota;Actinomycetes;Kitasatosporales;Streptomycetaceae;Streptomyces;Streptomyces sp. GS7	0	0	1	0	0	0	0	0	1
Bacteria;Bacteria_none;Pseudomonadota;Betaproteobacteria;Burkholderiales;Comamonadaceae;Comamonas;Comamonas thiooxydans	0	0	1	0	0	0	0	0	1
Bacteria;Bacteria_none;Pseudomonadota;Betaproteobacteria;Burkholderiales;Burkholderiaceae;Paraburkholderia;Paraburkholderia terrae	0	1	0	0	0	0	0	0	1
Bacteria;Bacteria_none;Pseudomonadota;Betaproteobacteria;Burkholderiales;Burkholderiaceae;Paraburkholderia;Paraburkholderia xenovorans	0	0	0	0	0	0	1	0	1
Bacteria;Bacteria_none;Pseudomonadota;Betaproteobacteria;Burkholderiales;Burkholderiaceae;Polynucleobacter;Polynucleobacter corsicus	0	0	0	0	0	0	0	1	1
Bacteria;Bacteria_none;Pseudomonadota;Betaproteobacteria;Burkholderiales;Burkholderiaceae;Polynucleobacter;Polynucleobacter sp. AP-Elch-400A-B2	0	0	0	0	0	0	0	1	1
Bacteria;Bacteria_none;Pseudomonadota;Betaproteobacteria;Burkholderiales;Burkholderiaceae;Polynucleobacter;Polynucleobacter sp. MWH-UH25E	0	0	0	0	0	0	0	1	1
Bacteria;Bacteria_none;Pseudomonadota;Betaproteobacteria;Burkholderiales;Comamonadaceae;Acidovorax;Acidovorax sp. JMULE5	0	0	0	0	1	0	0	0	1
Bacteria;Bacteria_none;Pseudomonadota;Alphaproteobacteria;Rhodobacterales;Roseobacteraceae;Leisingera;Leisingera sp. S132	1	0	0	0	0	0	0	0	1
Bacteria;Bacteria_none;Pseudomonadota;Alphaproteobacteria;Hyphomicrobiales;Nitrobacteraceae;Bradyrhizobium;Bradyrhizobium lablabi	0	0	0	1	0	0	0	0	1
Bacteria;Bacteria_none;Pseudomonadota;Alphaproteobacteria;Hyphomicrobiales;Methylocystaceae;Methylocystis;Methylocystis sp. SC2	0	0	0	0	0	0	0	1	1
Bacteria;Bacteria_none;Actinomycetota;Actinomycetes;Kitasatosporales;Streptomycetaceae;Streptomyces;Streptomyces sp. GMY02	0	0	0	0	0	1	0	0	1
Bacteria;Bacteria_none;Pseudomonadota;Betaproteobacteria;Burkholderiales;Comamonadaceae;Diaphorobacter;Diaphorobacter sp. HDW4A	0	0	0	0	0	0	1	0	1
Bacteria;Bacteria_none;Pseudomonadota;Betaproteobacteria;Burkholderiales;Comamonadaceae;Diaphorobacter;Diaphorobacter sp. HDW4B	0	0	0	0	0	0	1	0	1
Bacteria;Bacteria_none;Pseudomonadota;Betaproteobacteria;Burkholderiales;Comamonadaceae;Hydrogenophaga;Hydrogenophaga sp. BPS33	1	0	0	0	0	0	0	0	1
Bacteria;Bacteria_none;Pseudomonadota;Alphaproteobacteria;Hyphomicrobiales;Methylobacteriaceae;Methylorubrum;Methylorubrum sp. B1-46	0	0	0	0	0	1	0	0	1
Bacteria;Bacteria_none;Pseudomonadota;Alphaproteobacteria;Hyphomicrobiales;Methylobacteriaceae;Methylorubrum;Methylorubrum populi	0	0	0	0	0	0	0	1	1
Bacteria;Bacteria_none;Pseudomonadota;Betaproteobacteria;Burkholderiales;Comamonadaceae;Kinneretia;Kinneretia sp. DAIF2	0	0	0	0	1	0	0	0	1
Bacteria;Bacteria_none;Actinomycetota;Actinomycetes;Kitasatosporales;Streptomycetaceae;Streptomyces;Streptomyces rapamycinicus	0	1	0	0	0	0	0	0	1
Bacteria;Bacteria_none;Pseudomonadota;Betaproteobacteria;Burkholderiales;Comamonadaceae;Polaromonas;Polaromonas naphthalenivorans	0	0	0	0	0	0	1	0	1
Bacteria;Bacteria_none;Pseudomonadota;Betaproteobacteria;Burkholderiales;Burkholderiaceae;Paraburkholderia;Paraburkholderia sp. SOS3	0	0	1	0	0	0	0	0	1
Bacteria;Bacteria_none;Pseudomonadota;Alphaproteobacteria;Hyphomicrobiales;Nitrobacteraceae;Tardiphaga;Tardiphaga sp. 37S4	0	1	0	0	0	0	0	0	1
Bacteria;Bacteria_none;Pseudomonadota;Alphaproteobacteria;Hyphomicrobiales;Rhizobiaceae;Rhizobium;Rhizobium oryzihabitans	0	0	0	1	0	0	0	0	1
Bacteria;Bacteria_none;Pseudomonadota;Betaproteobacteria;Burkholderiales;Burkholderiaceae;Cupriavidus;Cupriavidus pinatubonensis	1	0	0	0	0	0	0	0	1
Bacteria;Bacteria_none;Pseudomonadota;Betaproteobacteria;Burkholderiales;Burkholderiaceae;Cupriavidus;Cupriavidus basilensis	0	0	0	0	0	1	0	0	1
Bacteria;Bacteria_none;Pseudomonadota;Betaproteobacteria;Burkholderiales;Burkholderiaceae;Cupriavidus;Cupriavidus campinensis	0	1	0	0	0	0	0	0	1
Bacteria;Bacteria_none;Pseudomonadota;Betaproteobacteria;Burkholderiales;Burkholderiaceae;Cupriavidus;Cupriavidus metallidurans	0	0	0	0	0	1	0	0	1
Bacteria;Bacteria_none;Pseudomonadota;Alphaproteobacteria;Hyphomicrobiales;Rhizobiaceae;Neorhizobium;Neorhizobium galegae	0	0	0	0	0	1	0	0	1
Bacteria;Bacteria_none;Pseudomonadota;Alphaproteobacteria;Hyphomicrobiales;Rhizobiaceae;Liberibacter;Candidatus Liberibacter solanacearum	0	0	0	0	0	1	0	0	1
Bacteria;Bacteria_none;Pseudomonadota;Betaproteobacteria;Burkholderiales;Burkholderiaceae;Cupriavidus;Cupriavidus necator	0	0	0	0	0	0	0	1	1
Bacteria;Bacteria_none;Pseudomonadota;Betaproteobacteria;Burkholderiales;Burkholderiaceae;Cupriavidus;Cupriavidus pauculus	0	0	0	1	0	0	0	0	1
Bacteria;Bacteria_none;Pseudomonadota;Alphaproteobacteria;Hyphomicrobiales;Rhizobiaceae;Agrobacterium;Agrobacterium vitis	0	0	0	0	0	0	0	1	1
Bacteria;Bacteria_none;Pseudomonadota;Alphaproteobacteria;Hyphomicrobiales;Rhizobiaceae;Agrobacterium;Agrobacterium vaccinii	0	1	0	0	0	0	0	0	1
Bacteria;Bacteria_none;Pseudomonadota;Alphaproteobacteria;Hyphomicrobiales;Nitrobacteraceae;Tardiphaga;Tardiphaga sp. vice154	0	0	0	0	0	0	1	0	1
Bacteria;Bacteria_none;Pseudomonadota;Alphaproteobacteria;Hyphomicrobiales;Phyllobacteriaceae;Phyllobacterium;Phyllobacterium sp. A18/5-2	0	1	0	0	0	0	0	0	1
Bacteria;Bacteria_none;Pseudomonadota;Alphaproteobacteria;Hyphomicrobiales;Phyllobacteriaceae;Mesorhizobium;Mesorhizobium sp. NZP2298	0	0	0	0	0	0	0	1	1
Bacteria;Bacteria_none;Pseudomonadota;Betaproteobacteria;Burkholderiales;Burkholderiaceae;Limnobacter;Limnobacter sp. SAORIC-580	0	0	0	0	1	0	0	0	1
Bacteria;Bacteria_none;Pseudomonadota;Alphaproteobacteria;Hyphomicrobiales;Phyllobacteriaceae;Mesorhizobium;Mesorhizobium sp. M3A.F.Ca.ET.080.04.2.1	0	0	0	0	0	1	0	0	1
Bacteria;Bacteria_none;Pseudomonadota;Alphaproteobacteria;Hyphomicrobiales;Phreatobacteraceae;Phreatobacter;Phreatobacter sp. NMCR1094	0	0	0	0	1	0	0	0	1
Bacteria;Bacteria_none;Pseudomonadota;Betaproteobacteria;Burkholderiales;Burkholderiaceae;Mycoavidus;Mycoavidus cysteinexigens	0	0	0	1	0	0	0	0	1
Bacteria;Bacteria_none;Pseudomonadota;Betaproteobacteria;Burkholderiales;Burkholderiaceae;Paraburkholderia;Paraburkholderia caledonica	0	0	0	0	0	0	1	0	1
Bacteria;Bacteria_none;Pseudomonadota;Betaproteobacteria;Burkholderiales;Burkholderiaceae;Paraburkholderia;Paraburkholderia caribensis	0	0	0	0	0	0	0	1	1
Bacteria;Bacteria_none;Bacillota;Bacilli;Bacillales;Bacillaceae;Cytobacillus;Cytobacillus firmus	0	0	0	0	1	0	0	0	1
Bacteria;Bacteria_none;Pseudomonadota;Gammaproteobacteria;Cellvibrionales;Cellvibrionaceae;Marinimicrobium;Marinimicrobium sp. C6131	0	0	0	0	0	1	0	0	1
Bacteria;Bacteria_none;Pseudomonadota;Epsilonproteobacteria;Campylobacterales;Arcobacteraceae;Malaciobacter;Malaciobacter halophilus	0	0	0	0	1	0	0	0	1
Bacteria;Bacteria_none;Pseudomonadota;Gammaproteobacteria;Vibrionales;Vibrionaceae;Photobacterium;Photobacterium profundum	0	0	0	1	0	0	0	0	1
Bacteria;Bacteria_none;Pseudomonadota;Gammaproteobacteria;Vibrionales;Vibrionaceae;Salinivibrio;Salinivibrio kushneri	0	0	1	0	0	0	0	0	1
Bacteria;Bacteria_none;Pseudomonadota;Gammaproteobacteria;Vibrionales;Vibrionaceae;Vibrio;Vibrio atlanticus	0	0	0	1	0	0	0	0	1
Bacteria;Bacteria_none;Pseudomonadota;Gammaproteobacteria;Vibrionales;Vibrionaceae;Vibrio;Vibrio crassostreae	0	0	1	0	0	0	0	0	1
Bacteria;Bacteria_none;Pseudomonadota;Gammaproteobacteria;Vibrionales;Vibrionaceae;Vibrio;Vibrio ishigakensis	0	0	0	0	0	0	1	0	1
Bacteria;Bacteria_none;Pseudomonadota;Gammaproteobacteria;Vibrionales;Vibrionaceae;Vibrio;Vibrio mangrovi	0	0	0	0	0	0	0	1	1
Bacteria;Bacteria_none;Actinomycetota;Actinomycetes;Actinomycetales;Actinomycetaceae;Actinomyces;Actinomyces naeslundii	0	0	0	0	1	0	0	0	1
Bacteria;Bacteria_none;Pseudomonadota;Gammaproteobacteria;Vibrionales;Vibrionaceae;Vibrio;Vibrio tubiashii	0	0	0	0	0	0	0	1	1
Bacteria;Bacteria_none;Pseudomonadota;Gammaproteobacteria;Xanthomonadales;Rhodanobacteraceae;Luteibacter;Luteibacter anthropi	0	0	0	0	0	0	0	1	1
Bacteria;Bacteria_none;Pseudomonadota;Gammaproteobacteria;Xanthomonadales;Rhodanobacteraceae;Luteibacter;Luteibacter sp. 335	1	0	0	0	0	0	0	0	1
Bacteria;Bacteria_none;Pseudomonadota;Gammaproteobacteria;Xanthomonadales;Xanthomonadaceae;Luteimonas;Luteimonas sp. YGD11-2	0	0	0	0	0	0	1	0	1
Bacteria;Bacteria_none;Pseudomonadota;Gammaproteobacteria;Xanthomonadales;Xanthomonadaceae;Stenotrophomonas;Stenotrophomonas rhizophila	0	0	0	0	1	0	0	0	1
Bacteria;Bacteria_none;Pseudomonadota;Gammaproteobacteria;Xanthomonadales;Xanthomonadaceae;Stenotrophomonas;Stenotrophomonas sp. SAU14A_NAIMI4_8	0	0	1	0	0	0	0	0	1
Bacteria;Bacteria_none;Pseudomonadota;Gammaproteobacteria;Xanthomonadales;Xanthomonadaceae;Xanthomonas;Xanthomonas cassavae	0	0	0	0	0	0	1	0	1
Archaea;Archaea_none;Thaumarchaeota;Nitrososphaeria;Nitrososphaerales;Nitrososphaeraceae;Nitrososphaera;Candidatus Nitrososphaera gargensis	0	0	0	0	0	0	0	1	1
Bacteria;Bacteria_none;Pseudomonadota;Gammaproteobacteria;Xanthomonadales;Xanthomonadaceae;Xanthomonas;Xanthomonas oryzae	0	0	0	0	1	0	0	0	1
Bacteria;Bacteria_none;Pseudomonadota;Gammaproteobacteria;Xanthomonadales;Xanthomonadaceae;Xanthomonas;Xanthomonas prunicola	0	0	0	1	0	0	0	0	1
Bacteria;Bacteria_none;Pseudomonadota;Gammaproteobacteria;Xanthomonadales;Xanthomonadaceae;Xanthomonas;Xanthomonas sacchari	0	0	0	0	0	0	0	1	1
Bacteria;Bacteria_none;Pseudomonadota;Gammaproteobacteria;Xanthomonadales;Xanthomonadaceae;Xanthomonas;Xanthomonas theicola	0	0	0	0	0	0	0	1	1
Bacteria;Bacteria_none;Pseudomonadota;Oligoflexia;Bacteriovoracales;Halobacteriovoraceae;Halobacteriovorax;Halobacteriovorax sp. BALOs_7	0	0	0	0	0	0	0	1	1
Bacteria;Bacteria_none;Pseudomonadota;Oligoflexia;Silvanigrellales;Silvanigrellaceae;Silvanigrella;Silvanigrella aquatica	0	0	0	1	0	0	0	0	1
Bacteria;Bacteria_none;Spirochaetota;Spirochaetia;Brachyspirales;Brachyspiraceae;Brachyspira;Brachyspira murdochii	0	0	0	0	1	0	0	0	1
Archaea;Archaea_none;Thaumarchaeota;Nitrososphaeria;Nitrososphaerales;Nitrososphaeraceae;Nitrososphaera;Candidatus Nitrososphaera evergladensis	0	0	0	0	0	0	0	1	1
Bacteria;Bacteria_none;Spirochaetota;Spirochaetia;Leptospirales;Leptospiraceae;Leptospira;Leptospira sp. GIMC2001	0	0	0	0	0	0	1	0	1
Bacteria;Bacteria_none;Pseudomonadota;Gammaproteobacteria;Vibrionales;Vibrionaceae;Photobacterium;Photobacterium swingsii	0	0	0	0	0	0	0	1	1
Bacteria;Bacteria_none;Pseudomonadota;Gammaproteobacteria;Vibrionales;Vibrionaceae;Aliivibrio;Aliivibrio fischeri	0	0	0	0	0	0	0	1	1
Bacteria;Bacteria_none;Spirochaetota;Spirochaetia;Spirochaetales;Borreliaceae;Borreliella;Candidatus Borreliella tachyglossi	0	0	0	0	0	0	0	1	1
Bacteria;Bacteria_none;Pseudomonadota;Gammaproteobacteria;Thiotrichales;Piscirickettsiaceae;Thiosulfatimonas;Thiosulfatimonas sediminis	0	0	0	0	0	0	0	1	1
Bacteria;Bacteria_none;Pseudomonadota;Gammaproteobacteria;Pseudomonadales;Marinobacteraceae;Marinobacter;Marinobacter salsuginis	0	0	0	0	0	0	0	1	1
Bacteria;Bacteria_none;Pseudomonadota;Gammaproteobacteria;Pseudomonadales;Pseudomonadaceae;Pseudomonas;Pseudomonas antarctica	0	0	0	0	0	0	0	1	1
Bacteria;Bacteria_none;Pseudomonadota;Gammaproteobacteria;Pseudomonadales;Pseudomonadaceae;Pseudomonas;Pseudomonas brenneri	0	0	0	0	0	0	1	0	1
Bacteria;Bacteria_none;Pseudomonadota;Gammaproteobacteria;Pseudomonadales;Pseudomonadaceae;Pseudomonas;Pseudomonas chlororaphis	0	0	0	0	0	0	1	0	1
Bacteria;Bacteria_none;Actinomycetota;Actinomycetes;Actinomycetales;Actinomycetaceae;Schaalia;Schaalia sp. JY-X169	0	0	0	0	0	0	0	1	1
Bacteria;Bacteria_none;Pseudomonadota;Gammaproteobacteria;Pseudomonadales;Pseudomonadaceae;Pseudomonas;Pseudomonas fragi	0	0	0	0	0	1	0	0	1
Bacteria;Bacteria_none;Pseudomonadota;Gammaproteobacteria;Pseudomonadales;Pseudomonadaceae;Pseudomonas;Pseudomonas frederiksbergensis	0	0	0	0	1	0	0	0	1
Bacteria;Bacteria_none;Pseudomonadota;Gammaproteobacteria;Pseudomonadales;Pseudomonadaceae;Pseudomonas;Pseudomonas knackmussii	0	1	0	0	0	0	0	0	1
Bacteria;Bacteria_none;Pseudomonadota;Gammaproteobacteria;Pseudomonadales;Pseudomonadaceae;Pseudomonas;Pseudomonas pohangensis	0	1	0	0	0	0	0	0	1
Bacteria;Bacteria_none;Pseudomonadota;Gammaproteobacteria;Pseudomonadales;Pseudomonadaceae;Pseudomonas;Pseudomonas rhodesiae	0	0	0	0	0	0	0	1	1
Bacteria;Bacteria_none;Pseudomonadota;Gammaproteobacteria;Pseudomonadales;Pseudomonadaceae;Pseudomonas;Pseudomonas seleniipraecipitans	0	0	0	0	0	0	0	1	1
Bacteria;Bacteria_none;Pseudomonadota;Gammaproteobacteria;Pseudomonadales;Pseudomonadaceae;Pseudomonas;Pseudomonas sp. B21-056	0	0	1	0	0	0	0	0	1
Bacteria;Bacteria_none;Pseudomonadota;Gammaproteobacteria;Pseudomonadales;Pseudomonadaceae;Pseudomonas;Pseudomonas sp. Cab53	0	0	0	0	1	0	0	0	1
Bacteria;Bacteria_none;Pseudomonadota;Gammaproteobacteria;Pseudomonadales;Pseudomonadaceae;Pseudomonas;Pseudomonas sp. DR 5-09	0	0	0	0	0	0	1	0	1
Bacteria;Bacteria_none;Pseudomonadota;Gammaproteobacteria;Pseudomonadales;Pseudomonadaceae;Pseudomonas;Pseudomonas sp. IT P374	0	0	0	0	0	0	0	1	1
Bacteria;Bacteria_none;Pseudomonadota;Gammaproteobacteria;Pseudomonadales;Pseudomonadaceae;Pseudomonas;Pseudomonas sp. LS44	0	0	0	0	0	0	0	1	1
Bacteria;Bacteria_none;Pseudomonadota;Gammaproteobacteria;Pseudomonadales;Pseudomonadaceae;Pseudomonas;Pseudomonas sp. MSPm1	0	0	0	1	0	0	0	0	1
Bacteria;Bacteria_none;Pseudomonadota;Gammaproteobacteria;Pseudomonadales;Pseudomonadaceae;Pseudomonas;Pseudomonas sp. Marseille-Q3773	0	0	0	0	0	0	0	1	1
Bacteria;Bacteria_none;Pseudomonadota;Gammaproteobacteria;Pseudomonadales;Pseudomonadaceae;Pseudomonas;Pseudomonas sp. URMO17WK12:I11	0	0	0	0	0	0	1	0	1
Bacteria;Bacteria_none;Pseudomonadota;Gammaproteobacteria;Pseudomonadales;Pseudomonadaceae;Pseudomonas;Pseudomonas vancouverensis	0	0	0	1	0	0	0	0	1
Bacteria;Bacteria_none;Pseudomonadota;Gammaproteobacteria;Pseudomonadales;Pseudomonadaceae;Pseudomonas;Pseudomonas vanderleydeniana	0	0	0	0	0	0	0	1	1
Bacteria;Bacteria_none;Pseudomonadota;Gammaproteobacteria;Thiotrichales;Piscirickettsiaceae;Piscirickettsia;Piscirickettsia salmonis	0	0	1	0	0	0	0	0	1
Bacteria;Bacteria_none;Pseudomonadota;Gammaproteobacteria;Thiotrichales;Piscirickettsiaceae;Thiomicrorhabdus;Thiomicrorhabdus xiamenensis	0	0	0	0	0	0	0	1	1
Bacteria;Bacteria_none;Spirochaetota;Spirochaetia;Leptospirales;Leptospiraceae;Leptospira;Leptospira tipperaryensis	0	0	0	0	0	1	0	0	1
Bacteria;Bacteria_none;Spirochaetota;Spirochaetia;Spirochaetales;Treponemataceae;Treponema;Treponema denticola	0	0	0	0	0	0	0	1	1
Bacteria;Bacteria_none;Actinomycetota;Actinomycetes;Kitasatosporales;Streptomycetaceae;Streptomyces;Streptomyces glaucescens	0	0	0	0	0	0	1	0	1
Archaea;Archaea_none;Euryarchaeota;Methanobacteria;Methanobacteriales;Methanobacteriaceae;Methanosphaera;Methanosphaera stadtmanae	0	0	0	0	0	0	0	1	1
Eukaryota;Fungi;Ascomycota;Saccharomycetes;Saccharomycetales;Saccharomycetaceae;Saccharomyces;Saccharomyces cerevisiae	0	0	0	1	0	0	0	0	1
Eukaryota;Fungi;Ascomycota;Saccharomycetes;Saccharomycetales;Trichomonascaceae;Sugiyamaella;Sugiyamaella lignohabitans	0	0	0	0	0	0	0	1	1
Eukaryota;Fungi;Ascomycota;Sordariomycetes;Hypocreales;Clavicipitaceae;Pochonia;Pochonia chlamydosporia	0	0	0	0	0	0	1	0	1
Archaea;Archaea_none;Euryarchaeota;Methanobacteria;Methanobacteriales;Methanobacteriaceae;Methanobacterium;Methanobacterium formicicum	0	0	0	0	0	0	0	1	1
Eukaryota;Fungi;Ascomycota;Sordariomycetes;Hypocreales;Nectriaceae;Fusarium;Fusarium musae	0	0	1	0	0	0	0	0	1
Archaea;Archaea_none;Euryarchaeota;Halobacteria;Natrialbales;Natrialbaceae;Halovivax;Halovivax ruber	0	0	0	0	0	0	0	1	1
Eukaryota;Fungi;Ascomycota;Sordariomycetes;Hypocreales;Nectriaceae;Fusarium;Fusarium venenatum	0	0	0	0	0	0	0	1	1
Eukaryota;Fungi;Ascomycota;Sordariomycetes;Magnaporthales;Pyriculariaceae;Pyricularia;Pyricularia grisea	0	0	0	0	0	0	1	0	1
Eukaryota;Fungi;Ascomycota;Sordariomycetes;Magnaporthales;Pyriculariaceae;Pyricularia;Pyricularia oryzae	0	0	0	0	0	0	0	1	1
Eukaryota;Fungi;Ascomycota;Sordariomycetes;Sordariales;Chaetomiaceae;Thermothelomyces;Thermothelomyces thermophilus	0	0	0	1	0	0	0	0	1
Eukaryota;Fungi;Ascomycota;Sordariomycetes;Sordariales;Sordariaceae;Neurospora;Neurospora crassa	0	0	0	1	0	0	0	0	1
Archaea;Archaea_none;Euryarchaeota;Halobacteria;Halobacteriales;Natronoarchaeaceae;Salinarchaeum;Salinarchaeum sp. Harcht-Bsk1	0	0	1	0	0	0	0	0	1
Archaea;Archaea_none;Euryarchaeota;Halobacteria;Halobacteriales;Haloarculaceae;Halosimplex;Halosimplex sp. XZYJT29	0	0	0	0	0	0	1	0	1
Archaea;Archaea_none;Euryarchaeota;Halobacteria;Halobacteriales;Haloarculaceae;Halorhabdus;Halorhabdus utahensis	0	0	0	0	0	0	0	1	1
Archaea;Archaea_none;Euryarchaeota;Archaeoglobi;Archaeoglobales;Archaeoglobaceae;Archaeoglobus;Archaeoglobus sulfaticallidus	1	0	0	0	0	0	0	0	1
Archaea;Archaea_none;Crenarchaeota;Thermoprotei;Thermoproteales;Thermoproteaceae;Pyrobaculum;Pyrobaculum aerophilum	0	0	0	0	1	0	0	0	1
Viruses;Bamfordvirae;Nucleocytoviricota;Megaviricetes;Imitervirales;Mimiviridae;Mimiviridae_Incertae_sedis;Moumouvirus	1	0	0	0	0	0	0	0	1
Viruses;Heunggongvirae;Uroviricota;Caudoviricetes;Caudoviricetes_Incertae_sedis;Autographiviridae;Napahaivirus;Napahaivirus VSW3	0	0	0	1	0	0	0	0	1
Viruses;Heunggongvirae;Uroviricota;Caudoviricetes;Caudoviricetes_Incertae_sedis;Caudoviricetes_Incertae_sedis_Incertae_sedis;Sextaecvirus;Sextaecvirus sextaec	0	0	0	0	1	0	0	0	1
Viruses;Heunggongvirae;Uroviricota;Caudoviricetes;Caudoviricetes_Incertae_sedis;Helgolandviridae;Leefvirus;Leefvirus Leef	0	0	0	0	0	0	1	0	1
Viruses;Heunggongvirae;Uroviricota;Caudoviricetes;Caudoviricetes_Incertae_sedis;Kyanoviridae;Bristolvirus;Bristolvirus rhodeisland	0	0	0	0	0	0	0	1	1
Viruses;Heunggongvirae;Uroviricota;Caudoviricetes;Crassvirales;Crevaviridae;Kingevirus;Kingevirus communis	0	0	0	0	0	0	1	0	1
Archaea;Archaea_none;Crenarchaeota;Thermoprotei;Sulfolobales;Sulfolobaceae;Sulfurisphaera;Sulfurisphaera ohwakuensis	0	0	0	0	0	0	0	1	1
Eukaryota;Fungi;Ascomycota;Saccharomycetes;Saccharomycetales;Debaryomycetaceae;Candida;Candida orthopsilosis	0	0	0	0	0	1	0	0	1
Eukaryota;Fungi;Ascomycota;Eurotiomycetes;Eurotiales;Aspergillaceae;Aspergillus;Aspergillus fumigatus	0	0	0	0	0	0	1	0	1
Bacteria;Bacteria_none;Spirochaetota;Spirochaetia;Spirochaetales;Treponemataceae;Treponema;Treponema peruense	0	0	0	0	0	0	1	0	1
Eukaryota;Eukaryota_Incertae_sedis;Eukaryota_Incertae_sedis_Incertae_sedis;Cryptophyceae;Pyrenomonadales;Geminigeraceae;Guillardia;Guillardia theta	0	0	0	1	0	0	0	0	1
Bacteria;Bacteria_none;Spirochaetota;Spirochaetia;Spirochaetales;Treponemataceae;Treponema;Treponema vincentii	0	0	0	0	0	0	0	1	1
Archaea;Archaea_none;Euryarchaeota;Thermococci;Thermococcales;Thermococcaceae;Thermococcus;Thermococcus guaymasensis	0	0	0	0	0	1	0	0	1
Bacteria;Bacteria_none;Thermodesulfobacteria;Thermodesulfobacteria;Thermodesulfobacteriales;Thermodesulfobacteriaceae;Caldimicrobium;Caldimicrobium thiodismutans	0	0	0	0	0	1	0	0	1
Bacteria;Bacteria_none;Thermotogota;Thermotogae;Kosmotogales;Kosmotogaceae;Kosmotoga;Kosmotoga olearia	0	0	0	0	0	0	0	1	1
Bacteria;Bacteria_none;Verrucomicrobiota;Verrucomicrobiae;Verrucomicrobiales;Akkermansiaceae;Akkermansia;Akkermansia muciniphila	0	0	0	0	0	0	1	0	1
Bacteria;Bacteria_none;Verrucomicrobiota;Verrucomicrobiae;Verrucomicrobiales;Verrucomicrobiaceae;Luteolibacter;Luteolibacter ambystomatis	0	0	0	1	0	0	0	0	1
Eukaryota;Eukaryota_Incertae_sedis;Apicomplexa;Aconoidasida;Haemosporida;Plasmodiidae;Plasmodium;Plasmodium chabaudi	0	0	0	0	0	0	0	1	1
Eukaryota;Eukaryota_Incertae_sedis;Apicomplexa;Aconoidasida;Haemosporida;Plasmodiidae;Plasmodium;Plasmodium cynomolgi	0	0	0	0	0	0	0	1	1
Eukaryota;Eukaryota_Incertae_sedis;Apicomplexa;Aconoidasida;Haemosporida;Plasmodiidae;Plasmodium;Plasmodium gaboni	0	0	0	0	1	0	0	0	1
Archaea;Archaea_none;Euryarchaeota;Thermococci;Thermococcales;Thermococcaceae;Pyrococcus;Pyrococcus kukulkanii	0	0	0	0	0	0	0	1	1
Archaea;Archaea_none;Euryarchaeota;Methanopyri;Methanopyrales;Methanopyraceae;Methanopyrus;Methanopyrus kandleri	0	0	0	0	1	0	0	0	1
Archaea;Archaea_none;Euryarchaeota;Methanomicrobia;Methanosarcinales;Methanosarcinaceae;Methanosarcina;Methanosarcina vacuolata	0	0	0	0	1	0	0	0	1
Eukaryota;Eukaryota_Incertae_sedis;Apicomplexa;Aconoidasida;Haemosporida;Plasmodiidae;Plasmodium;Plasmodium vivax	0	0	0	0	0	1	0	0	1
Eukaryota;Eukaryota_Incertae_sedis;Apicomplexa;Aconoidasida;Piroplasmida;Babesiidae;Babesia;Babesia bigemina	0	0	0	0	1	0	0	0	1
Eukaryota;Eukaryota_Incertae_sedis;Apicomplexa;Aconoidasida;Piroplasmida;Theileriidae;Theileria;Theileria annulata	0	0	0	0	0	1	0	0	1
Eukaryota;Eukaryota_Incertae_sedis;Apicomplexa;Aconoidasida;Piroplasmida;Theileriidae;Theileria;Theileria orientalis	0	0	0	0	1	0	0	0	1
Eukaryota;Eukaryota_Incertae_sedis;Apicomplexa;Aconoidasida;Piroplasmida;Theileriidae;Theileria;Theileria parva	0	0	0	1	0	0	0	0	1
Eukaryota;Eukaryota_Incertae_sedis;Apicomplexa;Conoidasida;Eucoccidiorida;Sarcocystidae;Besnoitia;Besnoitia besnoiti	0	0	0	0	0	0	0	1	1
Eukaryota;Eukaryota_Incertae_sedis;Bacillariophyta;Coscinodiscophyceae;Thalassiosirales;Thalassiosiraceae;Thalassiosira;Thalassiosira pseudonana	0	0	0	0	0	1	0	0	1
Eukaryota;Eukaryota_Incertae_sedis;Euglenozoa;Kinetoplastea;Trypanosomatida;Trypanosomatidae;Leishmania;Leishmania infantum	0	0	1	0	0	0	0	0	1
Archaea;Archaea_none;Euryarchaeota;Methanomicrobia;Methanosarcinales;Methanosarcinaceae;Methanohalobium;Methanohalobium evestigatum	0	0	0	0	0	0	1	0	1
Eukaryota;Eukaryota_Incertae_sedis;Euglenozoa;Kinetoplastea;Trypanosomatida;Trypanosomatidae;Trypanosoma;Trypanosoma brucei	0	0	0	0	0	0	0	1	1
Archaea;Archaea_none;Euryarchaeota;Methanomicrobia;Methanomicrobiales;Methanospirillaceae;Methanospirillum;Methanospirillum sp. J.3.6.1-F.2.7.3	0	0	0	0	1	0	0	0	1
Bacteria;Bacteria_none;Pseudomonadota;Gammaproteobacteria;Pseudomonadales;Marinobacteraceae;Marinobacter;Marinobacter fonticola	0	0	0	0	0	0	0	1	1
Bacteria;Bacteria_none;Pseudomonadota;Gammaproteobacteria;Pasteurellales;Pasteurellaceae;Rodentibacter;Rodentibacter haemolyticus	0	0	0	1	0	0	0	0	1
Bacteria;Bacteria_none;Pseudomonadota;Gammaproteobacteria;Pasteurellales;Pasteurellaceae;Pasteurella;Pasteurella dagmatis	0	0	0	0	0	0	0	1	1
Bacteria;Bacteria_none;Pseudomonadota;Gammaproteobacteria;Alteromonadales;Pseudoalteromonadaceae;Flocculibacter;Flocculibacter collagenilyticus	0	0	0	0	0	0	0	1	1
Bacteria;Bacteria_none;Actinomycetota;Actinomycetes;Kitasatosporales;Streptomycetaceae;Streptomyces;Streptomyces cyaneochromogenes	0	0	0	0	0	1	0	0	1
Bacteria;Bacteria_none;Pseudomonadota;Gammaproteobacteria;Alteromonadales;Pseudoalteromonadaceae;Pseudoalteromonas;Pseudoalteromonas sp. GCY	0	0	0	0	0	0	0	1	1
Bacteria;Bacteria_none;Pseudomonadota;Gammaproteobacteria;Alteromonadales;Shewanellaceae;Parashewanella;Parashewanella spongiae	0	0	0	0	0	0	0	1	1
Bacteria;Bacteria_none;Pseudomonadota;Gammaproteobacteria;Alteromonadales;Shewanellaceae;Parashewanella;Parashewanella tropica	0	0	0	0	0	1	0	0	1
Bacteria;Bacteria_none;Pseudomonadota;Gammaproteobacteria;Alteromonadales;Shewanellaceae;Shewanella;Shewanella avicenniae	0	0	0	0	0	0	0	1	1
Bacteria;Bacteria_none;Pseudomonadota;Gammaproteobacteria;Alteromonadales;Shewanellaceae;Shewanella;Shewanella baltica	0	0	0	1	0	0	0	0	1
Bacteria;Bacteria_none;Pseudomonadota;Gammaproteobacteria;Alteromonadales;Shewanellaceae;Shewanella;Shewanella donghaensis	0	1	0	0	0	0	0	0	1
Bacteria;Bacteria_none;Pseudomonadota;Gammaproteobacteria;Alteromonadales;Shewanellaceae;Shewanella;Shewanella frigidimarina	0	0	0	0	0	0	0	1	1
Bacteria;Bacteria_none;Pseudomonadota;Gammaproteobacteria;Alteromonadales;Shewanellaceae;Shewanella;Shewanella glacialimarina	0	0	0	0	0	0	0	1	1
Bacteria;Bacteria_none;Pseudomonadota;Gammaproteobacteria;Alteromonadales;Shewanellaceae;Shewanella;Shewanella inventionis	0	0	0	1	0	0	0	0	1
Bacteria;Bacteria_none;Pseudomonadota;Gammaproteobacteria;Alteromonadales;Shewanellaceae;Shewanella;Shewanella psychrophila	0	0	0	0	1	0	0	0	1
Bacteria;Bacteria_none;Pseudomonadota;Gammaproteobacteria;Alteromonadales;Shewanellaceae;Shewanella;Shewanella putrefaciens	0	1	0	0	0	0	0	0	1
Bacteria;Bacteria_none;Pseudomonadota;Gammaproteobacteria;Alteromonadales;Shewanellaceae;Shewanella;Shewanella sp. FJAT-51860	0	0	0	0	0	0	0	1	1
Bacteria;Bacteria_none;Pseudomonadota;Gammaproteobacteria;Alteromonadales;Shewanellaceae;Shewanella;Shewanella sp. MTB7	0	0	1	0	0	0	0	0	1
Bacteria;Bacteria_none;Pseudomonadota;Gammaproteobacteria;Alteromonadales;Shewanellaceae;Shewanella;Shewanella violacea	0	0	0	0	0	0	0	1	1
Bacteria;Bacteria_none;Pseudomonadota;Gammaproteobacteria;Cardiobacteriales;Cardiobacteriaceae;Cardiobacterium;Cardiobacterium hominis	0	0	0	0	0	1	0	0	1
Bacteria;Bacteria_none;Planctomycetota;Planctomycetia;Pirellulales;Pirellulaceae;Bremerella;Bremerella volcania	0	0	0	0	0	0	1	0	1
Bacteria;Bacteria_none;Pseudomonadota;Gammaproteobacteria;Chromatiales;Chromatiaceae;Nitrosococcus;Nitrosococcus watsonii	0	0	0	0	0	0	0	1	1
Bacteria;Bacteria_none;Pseudomonadota;Gammaproteobacteria;Chromatiales;Ectothiorhodospiraceae;Spiribacter;Spiribacter sp. E85	0	0	0	0	0	0	1	0	1
Bacteria;Bacteria_none;Pseudomonadota;Gammaproteobacteria;Chromatiales;Wenzhouxiangellaceae;Wenzhouxiangella;Wenzhouxiangella sp. AB-CW3	0	0	0	0	0	1	0	0	1
Bacteria;Bacteria_none;Pseudomonadota;Gammaproteobacteria;Enterobacterales;Budviciaceae;Jinshanibacter;Jinshanibacter zhutongyuii	0	0	0	1	0	0	0	0	1
Bacteria;Bacteria_none;Pseudomonadota;Gammaproteobacteria;Enterobacterales;Enterobacteriaceae;Candidatus Blochmannia;Candidatus Blochmannia ocreatus	0	0	0	0	0	1	0	0	1
Bacteria;Bacteria_none;Actinomycetota;Actinomycetes;Kitasatosporales;Streptomycetaceae;Streptomyces;Streptomyces capitiformicae	0	0	0	0	0	1	0	0	1
Bacteria;Bacteria_none;Actinomycetota;Actinomycetes;Kitasatosporales;Streptomycetaceae;Streptomyces;Streptomyces davaonensis	0	0	0	0	0	1	0	0	1
Bacteria;Bacteria_none;Pseudomonadota;Gammaproteobacteria;Alteromonadales;Moritellaceae;Moritella;Moritella sp. 5	0	0	0	0	1	0	0	0	1
Bacteria;Bacteria_none;Pseudomonadota;Gammaproteobacteria;Pasteurellales;Pasteurellaceae;Pasteurella;Pasteurella canis	0	0	0	0	0	0	0	1	1
Bacteria;Bacteria_none;Pseudomonadota;Gammaproteobacteria;Alteromonadales;Colwelliaceae;Thalassotalea;Thalassotalea sp. HSM 43	0	0	0	0	0	0	1	0	1
Bacteria;Bacteria_none;Pseudomonadota;Epsilonproteobacteria;Campylobacterales;Campylobacteraceae;Campylobacter;Campylobacter concisus	0	0	0	0	0	1	0	0	1
Bacteria;Bacteria_none;Pseudomonadota;Epsilonproteobacteria;Campylobacterales;Campylobacteraceae;Campylobacter;Campylobacter curvus	0	0	0	0	0	0	0	1	1
Bacteria;Bacteria_none;Pseudomonadota;Epsilonproteobacteria;Campylobacterales;Campylobacteraceae;Campylobacter;Campylobacter geochelonis	0	0	0	0	0	0	0	1	1
Bacteria;Bacteria_none;Pseudomonadota;Epsilonproteobacteria;Campylobacterales;Campylobacteraceae;Campylobacter;Campylobacter hominis	0	0	0	0	0	1	0	0	1
Bacteria;Bacteria_none;Pseudomonadota;Epsilonproteobacteria;Campylobacterales;Campylobacteraceae;Campylobacter;Campylobacter mucosalis	0	0	0	0	0	1	0	0	1
Bacteria;Bacteria_none;Actinomycetota;Actinomycetes;Kitasatosporales;Streptomycetaceae;Streptomyces;Streptomyces genisteinicus	0	0	0	0	1	0	0	0	1
Bacteria;Bacteria_none;Pseudomonadota;Epsilonproteobacteria;Campylobacterales;Campylobacteraceae;Campylobacter;Campylobacter pinnipediorum	0	0	0	1	0	0	0	0	1
Bacteria;Bacteria_none;Pseudomonadota;Epsilonproteobacteria;Campylobacterales;Campylobacteraceae;Campylobacter;Campylobacter ureolyticus	0	0	0	0	1	0	0	0	1
Bacteria;Bacteria_none;Pseudomonadota;Epsilonproteobacteria;Campylobacterales;Thiovulaceae;Sulfurimonas;Candidatus Sulfurimonas baltica	0	0	0	0	0	0	0	1	1
Bacteria;Bacteria_none;Pseudomonadota;Epsilonproteobacteria;Campylobacterales;Thiovulaceae;Sulfurimonas;Candidatus Sulfurimonas marisnigri	0	1	0	0	0	0	0	0	1
Bacteria;Bacteria_none;Pseudomonadota;Epsilonproteobacteria;Campylobacterales;Thiovulaceae;Sulfurimonas;Sulfurimonas lithotrophica	0	0	0	0	0	0	0	1	1
Bacteria;Bacteria_none;Pseudomonadota;Gammaproteobacteria;Acidiferrobacterales;Acidiferrobacteraceae;Sulfurifustis;Sulfurifustis variabilis	0	0	0	1	0	0	0	0	1
Bacteria;Bacteria_none;Pseudomonadota;Gammaproteobacteria;Aeromonadales;Aeromonadaceae;Aeromonas;Aeromonas hydrophila	0	0	0	0	1	0	0	0	1
Bacteria;Bacteria_none;Pseudomonadota;Gammaproteobacteria;Aeromonadales;Aeromonadaceae;Aeromonas;Aeromonas rivuli	0	1	0	0	0	0	0	0	1
Bacteria;Bacteria_none;Pseudomonadota;Gammaproteobacteria;Aeromonadales;Aeromonadaceae;Aeromonas;Aeromonas schubertii	0	0	0	0	0	0	1	0	1
Bacteria;Bacteria_none;Pseudomonadota;Gammaproteobacteria;Aeromonadales;Aeromonadaceae;Aeromonas;Aeromonas veronii	0	0	0	0	0	0	0	1	1
Bacteria;Bacteria_none;Pseudomonadota;Gammaproteobacteria;Alteromonadales;Alteromonadaceae;Glaciecola;Glaciecola nitratireducens	0	0	0	0	0	0	0	1	1
Bacteria;Bacteria_none;Pseudomonadota;Gammaproteobacteria;Alteromonadales;Alteromonadaceae;Paraglaciecola;Paraglaciecola mesophila	0	0	0	0	0	0	1	0	1
Bacteria;Bacteria_none;Pseudomonadota;Gammaproteobacteria;Alteromonadales;Alteromonadaceae;Paraglaciecola;Paraglaciecola psychrophila	0	0	0	0	1	0	0	0	1
Bacteria;Bacteria_none;Pseudomonadota;Gammaproteobacteria;Alteromonadales;Alteromonadaceae;Paraneptunicella;Paraneptunicella aestuarii	0	0	0	0	0	1	0	0	1
Bacteria;Bacteria_none;Pseudomonadota;Gammaproteobacteria;Alteromonadales;Colwelliaceae;Colwellia;Colwellia psychrerythraea	0	1	0	0	0	0	0	0	1
Bacteria;Bacteria_none;Pseudomonadota;Gammaproteobacteria;Alteromonadales;Colwelliaceae;Colwellia;Colwellia sp. M166	0	0	0	0	0	0	0	1	1
Bacteria;Bacteria_none;Pseudomonadota;Gammaproteobacteria;Alteromonadales;Colwelliaceae;Thalassomonas;Thalassomonas haliotis	0	0	0	1	0	0	0	0	1
Bacteria;Bacteria_none;Actinomycetota;Actinomycetes;Kitasatosporales;Streptomycetaceae;Kitasatospora;Kitasatospora sp. NA04385	0	0	0	0	0	1	0	0	1
Bacteria;Bacteria_none;Actinomycetota;Actinomycetes;Kitasatosporales;Streptomycetaceae;Kitasatospora;Kitasatospora sp. HUAS 3-15	0	0	0	0	0	1	0	0	1
Bacteria;Bacteria_none;Pseudomonadota;Gammaproteobacteria;Enterobacterales;Enterobacteriaceae;Enterobacter;Enterobacter oligotrophicus	0	0	0	0	0	0	0	1	1
Bacteria;Bacteria_none;Pseudomonadota;Gammaproteobacteria;Enterobacterales;Enterobacteriaceae;Enterobacter;Enterobacter roggenkampii	0	0	0	0	0	1	0	0	1
Bacteria;Bacteria_none;Pseudomonadota;Gammaproteobacteria;Moraxellales;Moraxellaceae;Acinetobacter;Acinetobacter bereziniae	0	0	0	0	0	0	1	0	1
Bacteria;Bacteria_none;Pseudomonadota;Gammaproteobacteria;Moraxellales;Moraxellaceae;Acinetobacter;Acinetobacter guillouiae	1	0	0	0	0	0	0	0	1
Bacteria;Bacteria_none;Actinomycetota;Actinomycetes;Bifidobacteriales;Bifidobacteriaceae;Bifidobacterium;Bifidobacterium catenulatum	0	0	0	0	0	0	0	1	1
Bacteria;Bacteria_none;Pseudomonadota;Gammaproteobacteria;Moraxellales;Moraxellaceae;Acinetobacter;Acinetobacter portensis	0	0	0	0	0	1	0	0	1
Bacteria;Bacteria_none;Pseudomonadota;Gammaproteobacteria;Moraxellales;Moraxellaceae;Acinetobacter;Acinetobacter sp. AS23	1	0	0	0	0	0	0	0	1
Bacteria;Bacteria_none;Pseudomonadota;Gammaproteobacteria;Moraxellales;Moraxellaceae;Acinetobacter;Acinetobacter sp. WCHAc010034	0	0	0	0	0	0	0	1	1
Bacteria;Bacteria_none;Pseudomonadota;Gammaproteobacteria;Moraxellales;Moraxellaceae;Acinetobacter;Acinetobacter sp. Y-23	0	0	0	0	1	0	0	0	1
Bacteria;Bacteria_none;Pseudomonadota;Gammaproteobacteria;Moraxellales;Moraxellaceae;Acinetobacter;Acinetobacter ursingii	1	0	0	0	0	0	0	0	1
Bacteria;Bacteria_none;Pseudomonadota;Gammaproteobacteria;Moraxellales;Moraxellaceae;Acinetobacter;Acinetobacter vivianii	0	0	0	0	0	1	0	0	1
Bacteria;Bacteria_none;Actinomycetota;Actinomycetes;Bifidobacteriales;Bifidobacteriaceae;Bifidobacterium;Bifidobacterium asteroides	0	0	0	1	0	0	0	0	1
Bacteria;Bacteria_none;Pseudomonadota;Gammaproteobacteria;Moraxellales;Moraxellaceae;Psychrobacter;Psychrobacter urativorans	0	0	0	0	0	1	0	0	1
Bacteria;Bacteria_none;Pseudomonadota;Gammaproteobacteria;Oceanospirillales;Alcanivoracaceae;Alloalcanivorax;Alloalcanivorax dieselolei	0	0	0	1	0	0	0	0	1
Bacteria;Bacteria_none;Pseudomonadota;Gammaproteobacteria;Oceanospirillales;Alcanivoracaceae;Ketobacter;Ketobacter alkanivorans	0	0	0	0	0	0	1	0	1
Bacteria;Bacteria_none;Pseudomonadota;Gammaproteobacteria;Oceanospirillales;Endozoicomonadaceae;Endozoicomonas;Endozoicomonas euniceicola	0	0	0	1	0	0	0	0	1
Bacteria;Bacteria_none;Pseudomonadota;Gammaproteobacteria;Oceanospirillales;Halomonadaceae;Halomonas;Halomonas aestuarii	0	0	0	0	1	0	0	0	1
Bacteria;Bacteria_none;Pseudomonadota;Gammaproteobacteria;Oceanospirillales;Halomonadaceae;Halomonas;Halomonas campaniensis	0	0	0	0	0	0	0	1	1
Bacteria;Bacteria_none;Pseudomonadota;Gammaproteobacteria;Oceanospirillales;Halomonadaceae;Halomonas;Halomonas sp. A40-4	0	0	0	0	0	1	0	0	1
Bacteria;Bacteria_none;Pseudomonadota;Gammaproteobacteria;Oceanospirillales;Halomonadaceae;Halomonas;Halomonas venusta	0	0	0	1	0	0	0	0	1
Bacteria;Bacteria_none;Pseudomonadota;Gammaproteobacteria;Oceanospirillales;Halomonadaceae;Kushneria;Kushneria marisflavi	0	0	0	0	0	0	0	1	1
Bacteria;Bacteria_none;Pseudomonadota;Gammaproteobacteria;Oceanospirillales;Oceanospirillaceae;Aliamphritea;Aliamphritea ceti	0	0	0	1	0	0	0	0	1
Bacteria;Bacteria_none;Pseudomonadota;Gammaproteobacteria;Orbales;Orbaceae;Gilliamella;Gilliamella apicola	0	0	0	0	1	0	0	0	1
Bacteria;Bacteria_none;Actinomycetota;Actinomycetes;Actinomycetales;Actinomycetaceae;Varibaculum;Varibaculum prostatecancerukia	0	0	0	0	0	0	0	1	1
Bacteria;Bacteria_none;Actinomycetota;Actinomycetes;Actinomycetales;Actinomycetaceae;Trueperella;Trueperella pyogenes	0	0	0	0	0	0	0	1	1
Bacteria;Bacteria_none;Pseudomonadota;Gammaproteobacteria;Methylococcales;Methylococcaceae;Methylococcus;Methylococcus capsulatus	0	0	0	0	0	1	0	0	1
Bacteria;Bacteria_none;Pseudomonadota;Gammaproteobacteria;Legionellales;Legionellaceae;Legionella;Legionella pneumophila	0	0	0	0	0	0	1	0	1
Bacteria;Bacteria_none;Pseudomonadota;Gammaproteobacteria;Legionellales;Legionellaceae;Legionella;Legionella jordanis	0	0	0	0	0	0	0	1	1
Bacteria;Bacteria_none;Pseudomonadota;Gammaproteobacteria;Enterobacterales;Erwiniaceae;Pantoea;Pantoea eucrina	0	0	1	0	0	0	0	0	1
Bacteria;Bacteria_none;Pseudomonadota;Gammaproteobacteria;Enterobacterales;Enterobacteriaceae;Enterobacteriaceae_Incertae_sedis;Enterobacteriaceae endosymbiont of Donacia simplex	0	0	0	0	0	0	0	1	1
Bacteria;Bacteria_none;Pseudomonadota;Gammaproteobacteria;Enterobacterales;Enterobacteriaceae;Escherichia;Escherichia albertii	0	0	0	0	0	0	1	0	1
Bacteria;Bacteria_none;Actinomycetota;Actinomycetes;Jiangellales;Jiangellaceae;Jiangella;Jiangella alkaliphila	0	0	0	1	0	0	0	0	1
Bacteria;Bacteria_none;Pseudomonadota;Gammaproteobacteria;Enterobacterales;Enterobacteriaceae;Escherichia;Escherichia fergusonii	0	0	0	0	1	0	0	0	1
Bacteria;Bacteria_none;Pseudomonadota;Gammaproteobacteria;Enterobacterales;Enterobacteriaceae;Kosakonia;Kosakonia radicincitans	0	0	1	0	0	0	0	0	1
Bacteria;Bacteria_none;Pseudomonadota;Gammaproteobacteria;Enterobacterales;Enterobacteriaceae;Lelliottia;Lelliottia amnigena	0	1	0	0	0	0	0	0	1
Bacteria;Bacteria_none;Actinomycetota;Actinomycetes;Candidatus Nanopelagicales;Candidatus Nanopelagicaceae;Candidatus Nanopelagicus;Candidatus Nanopelagicus limnes	0	0	0	0	0	0	0	1	1
Bacteria;Bacteria_none;Actinomycetota;Actinomycetes;Candidatus Nanopelagicales;Candidatus Nanopelagicaceae;Candidatus Nanopelagicus;Candidatus Nanopelagicus abundans	0	0	0	1	0	0	0	0	1
Bacteria;Bacteria_none;Actinomycetota;Actinomycetes;Bifidobacteriales;Bifidobacteriaceae;Parascardovia;Parascardovia denticolens	0	0	0	0	0	0	0	1	1
Bacteria;Bacteria_none;Actinomycetota;Actinomycetes;Bifidobacteriales;Bifidobacteriaceae;Bifidobacterium;Bifidobacterium subtile	0	0	0	0	0	0	0	1	1
Bacteria;Bacteria_none;Pseudomonadota;Gammaproteobacteria;Enterobacterales;Erwiniaceae;Pantoea;Pantoea sp. CCBC3-3-1	0	0	0	0	1	0	0	0	1
Bacteria;Bacteria_none;Pseudomonadota;Gammaproteobacteria;Legionellales;Legionellaceae;Legionella;Legionella endosymbiont of Polyplax serrata	0	0	0	1	0	0	0	0	1
Bacteria;Bacteria_none;Pseudomonadota;Gammaproteobacteria;Enterobacterales;Erwiniaceae;Pantoea;Pantoea sp. Z09	0	0	0	0	0	0	1	0	1
Bacteria;Bacteria_none;Pseudomonadota;Gammaproteobacteria;Enterobacterales;Erwiniaceae;Tatumella;Tatumella citrea	0	0	0	0	1	0	0	0	1
Bacteria;Bacteria_none;Pseudomonadota;Gammaproteobacteria;Enterobacterales;Morganellaceae;Photorhabdus;Photorhabdus thracensis	0	0	0	0	0	0	0	1	1
Bacteria;Bacteria_none;Pseudomonadota;Gammaproteobacteria;Enterobacterales;Morganellaceae;Proteus;Proteus mirabilis	0	0	0	0	0	0	0	1	1
Bacteria;Bacteria_none;Actinomycetota;Actinomycetes;Bifidobacteriales;Bifidobacteriaceae;Bifidobacterium;Bifidobacterium imperatoris	0	0	0	0	0	0	0	1	1
Bacteria;Bacteria_none;Pseudomonadota;Gammaproteobacteria;Enterobacterales;Morganellaceae;Xenorhabdus;Xenorhabdus doucetiae	0	0	0	0	0	0	0	1	1
Bacteria;Bacteria_none;Pseudomonadota;Gammaproteobacteria;Enterobacterales;Pectobacteriaceae;Dickeya;Dickeya chrysanthemi	0	0	0	1	0	0	0	0	1
Bacteria;Bacteria_none;Actinomycetota;Actinomycetes;Bifidobacteriales;Bifidobacteriaceae;Bifidobacterium;Bifidobacterium eulemuris	0	0	0	0	0	0	1	0	1
Bacteria;Bacteria_none;Pseudomonadota;Gammaproteobacteria;Enterobacterales;Yersiniaceae;Yersinia;Yersinia rohdei	0	0	0	0	1	0	0	0	1
Bacteria;Bacteria_none;Pseudomonadota;Gammaproteobacteria;Gammaproteobacteria_Incertae_sedis;Gammaproteobacteria_Incertae_sedis_Incertae_sedis;Candidatus Pseudothioglobus;Candidatus Pseudothioglobus singularis	0	0	0	0	1	0	0	0	1
Bacteria;Bacteria_none;Planctomycetota;Planctomycetia;Pirellulales;Pirellulaceae;Mariniblastus;Mariniblastus fucicola	0	0	0	0	0	0	0	1	1
Bacteria;Bacteria_none;Cyanobacteriota;Cyanophyceae;Nostocales;Calotrichaceae;Calothrix;Calothrix parasitica	0	0	0	0	0	0	0	1	1
Bacteria;Bacteria_none;Planctomycetota;Planctomycetia;Pirellulales;Lacipirellulaceae;Lacipirellula;Lacipirellula limnantheis	0	0	0	0	0	0	0	1	1
Bacteria;Bacteria_none;Bacillota;Clostridia;Eubacteriales;Clostridiaceae;Clostridium;Clostridium sp. BJN0001	0	0	0	0	0	0	0	1	1
Bacteria;Bacteria_none;Actinomycetota;Actinomycetes;Propionibacteriales;Nocardioidaceae;Nocardioides;Nocardioides rotundus	0	0	0	0	0	1	0	0	1
Bacteria;Bacteria_none;Bacillota;Clostridia;Eubacteriales;Clostridiaceae;Clostridium;Clostridium cadaveris	0	0	0	1	0	0	0	0	1
Bacteria;Bacteria_none;Bacillota;Clostridia;Eubacteriales;Clostridiaceae;Clostridium;Clostridium carboxidivorans	0	0	0	0	1	0	0	0	1
Bacteria;Bacteria_none;Bacillota;Clostridia;Eubacteriales;Clostridiaceae;Clostridium;Clostridium drakei	0	0	0	0	0	0	0	1	1
Bacteria;Bacteria_none;Actinomycetota;Actinomycetes;Propionibacteriales;Nocardioidaceae;Nocardioides;Nocardioides aromaticivorans	0	0	0	0	1	0	0	0	1
Bacteria;Bacteria_none;Bacillota;Clostridia;Eubacteriales;Clostridiaceae;Clostridium;Clostridium formicaceticum	0	0	1	0	0	0	0	0	1
Bacteria;Bacteria_none;Bacillota;Clostridia;Eubacteriales;Clostridiaceae;Clostridium;Clostridium gelidum	0	0	0	0	0	1	0	0	1
Bacteria;Bacteria_none;Actinomycetota;Actinomycetes;Propionibacteriales;Nocardioidaceae;Marmoricola;Marmoricola scoriae	0	0	0	0	0	1	0	0	1
Bacteria;Bacteria_none;Bacillota;Clostridia;Eubacteriales;Clostridiaceae;Clostridium;Clostridium saccharobutylicum	0	0	0	0	0	0	0	1	1
Bacteria;Bacteria_none;Bacillota;Clostridia;Eubacteriales;Clostridiaceae;Clostridium;Clostridium saccharoperbutylacetonicum	0	0	1	0	0	0	0	0	1
Bacteria;Bacteria_none;Bacillota;Clostridia;Eubacteriales;Clostridiaceae;Clostridium;Clostridium septicum	0	0	0	1	0	0	0	0	1
Bacteria;Bacteria_none;Bacillota;Clostridia;Eubacteriales;Clostridiaceae;Clostridium;Clostridium sp. DL-VIII	0	0	0	0	0	0	0	1	1
Bacteria;Bacteria_none;Actinomycetota;Actinomycetes;Propionibacteriales;Nocardioidaceae;Nocardioides;Nocardioides sambongensis	0	1	0	0	0	0	0	0	1
Bacteria;Bacteria_none;Bacillota;Clostridia;Eubacteriales;Clostridiaceae;Clostridium;Clostridium thermarum	0	0	0	1	0	0	0	0	1
Bacteria;Bacteria_none;Bacillota;Clostridia;Eubacteriales;Clostridiaceae;Crassaminicella;Crassaminicella profunda	0	0	0	0	0	0	0	1	1
Bacteria;Bacteria_none;Bacillota;Clostridia;Eubacteriales;Clostridiaceae;Crassaminicella;Crassaminicella sp. 143-21	0	0	1	0	0	0	0	0	1
Bacteria;Bacteria_none;Bacillota;Clostridia;Eubacteriales;Clostridiaceae;Crassaminicella;Crassaminicella thermophila	0	0	0	0	0	0	1	0	1
Bacteria;Bacteria_none;Bacillota;Clostridia;Eubacteriales;Clostridiaceae;Geosporobacter;Geosporobacter ferrireducens	0	0	0	0	0	0	0	1	1
Bacteria;Bacteria_none;Bacillota;Clostridia;Eubacteriales;Clostridiaceae;Paraclostridium;Paraclostridium bifermentans	0	0	0	0	0	0	0	1	1
Bacteria;Bacteria_none;Bacillota;Clostridia;Eubacteriales;Clostridiaceae;Sarcina;Sarcina sp. JB2	0	0	0	0	0	0	0	1	1
Bacteria;Bacteria_none;Bacillota;Clostridia;Eubacteriales;Desulfitobacteriaceae;Desulfitobacterium;Desulfitobacterium metallireducens	0	0	0	0	0	0	0	1	1
Bacteria;Bacteria_none;Bacillota;Clostridia;Eubacteriales;Eubacteriaceae;Alkalibacter;Alkalibacter rhizosphaerae	0	0	0	0	0	0	0	1	1
Bacteria;Bacteria_none;Bacillota;Clostridia;Eubacteriales;Eubacteriales Family XIII. Incertae Sedis;Aminipila;Aminipila butyrica	0	0	0	1	0	0	0	0	1
Bacteria;Bacteria_none;Actinomycetota;Actinomycetes;Nakamurellales;Nakamurellaceae;Nakamurella;Nakamurella multipartita	0	0	0	0	0	0	1	0	1
Bacteria;Bacteria_none;Bacillota;Clostridia;Eubacteriales;Clostridiaceae;Clostridium;Clostridium botulinum	0	0	0	0	0	0	0	1	1
Bacteria;Bacteria_none;Bacillota;Clostridia;Eubacteriales;Clostridiaceae;Clostridium;Clostridium aceticum	0	0	0	0	0	0	0	1	1
Bacteria;Bacteria_none;Actinomycetota;Actinomycetes;Mycobacteriales;Mycobacteriaceae;Mycobacterium;Mycobacterium heidelbergense	0	0	0	0	0	1	0	0	1
Bacteria;Bacteria_none;Actinomycetota;Actinomycetes;Pseudonocardiales;Pseudonocardiaceae;Alloactinosynnema;Alloactinosynnema sp. L-07	0	0	0	0	0	0	0	1	1
Bacteria;Bacteria_none;Bacillota;Bacilli;Lactobacillales;Streptococcaceae;Streptococcus;Streptococcus gwangjuense	0	0	0	0	0	0	0	1	1
Bacteria;Bacteria_none;Bacillota;Bacilli;Lactobacillales;Streptococcaceae;Streptococcus;Streptococcus himalayensis	0	1	0	0	0	0	0	0	1
Bacteria;Bacteria_none;Bacillota;Bacilli;Lactobacillales;Streptococcaceae;Streptococcus;Streptococcus ilei	0	0	1	0	0	0	0	0	1
Bacteria;Bacteria_none;Bacillota;Bacilli;Lactobacillales;Streptococcaceae;Streptococcus;Streptococcus milleri	0	0	0	1	0	0	0	0	1
Bacteria;Bacteria_none;Actinomycetota;Actinomycetes;Pseudonocardiales;Pseudonocardiaceae;Pseudonocardia;Pseudonocardia sp. HH130630-07	0	0	0	0	1	0	0	0	1
Bacteria;Bacteria_none;Bacillota;Bacilli;Lactobacillales;Streptococcaceae;Streptococcus;Streptococcus oriscaviae	0	0	0	0	0	0	0	1	1
Bacteria;Bacteria_none;Bacillota;Bacilli;Lactobacillales;Streptococcaceae;Streptococcus;Streptococcus parauberis	0	0	0	0	0	0	1	0	1
Bacteria;Bacteria_none;Bacillota;Bacilli;Lactobacillales;Streptococcaceae;Streptococcus;Streptococcus periodonticum	1	0	0	0	0	0	0	0	1
Bacteria;Bacteria_none;Bacillota;Bacilli;Lactobacillales;Streptococcaceae;Streptococcus;Streptococcus pluranimalium	1	0	0	0	0	0	0	0	1
Bacteria;Bacteria_none;Actinomycetota;Actinomycetes;Pseudonocardiales;Pseudonocardiaceae;Amycolatopsis;Amycolatopsis acidiphila	0	0	0	0	0	0	1	0	1
Bacteria;Bacteria_none;Actinomycetota;Actinomycetes;Pseudonocardiales;Pseudonocardiaceae;Allokutzneria;Allokutzneria albata	0	0	0	0	0	1	0	0	1
Bacteria;Bacteria_none;Bacillota;Bacilli;Lactobacillales;Streptococcaceae;Streptococcus;Streptococcus respiraculi	0	0	0	0	0	0	0	1	1
Bacteria;Bacteria_none;Bacillota;Clostridia;Eubacteriales;Clostridiaceae;Caloramator;Caloramator sp. Dgby_cultured_2	0	0	0	0	0	0	0	1	1
Bacteria;Bacteria_none;Bacillota;Bacilli;Lactobacillales;Streptococcaceae;Streptococcus;Streptococcus rubneri	0	0	0	0	0	0	0	1	1
Bacteria;Bacteria_none;Bacillota;Bacilli;Lactobacillales;Streptococcaceae;Streptococcus;Streptococcus ruminantium	0	0	0	0	1	0	0	0	1
Bacteria;Bacteria_none;Actinomycetota;Actinomycetes;Pseudonocardiales;Pseudonocardiaceae;Actinosynnema;Actinosynnema pretiosum	1	0	0	0	0	0	0	0	1
Bacteria;Bacteria_none;Actinomycetota;Actinomycetes;Pseudonocardiales;Pseudonocardiaceae;Actinoalloteichus;Actinoalloteichus sp. GBA129-24	0	0	0	0	0	1	0	0	1
Bacteria;Bacteria_none;Bacillota;Bacilli;Lactobacillales;Streptococcaceae;Streptococcus;Streptococcus sp. 116-D4	0	0	0	0	0	1	0	0	1
Bacteria;Bacteria_none;Bacillota;Bacilli;Lactobacillales;Streptococcaceae;Streptococcus;Streptococcus sp. A12	0	0	0	0	1	0	0	0	1
Bacteria;Bacteria_none;Bacillota;Bacilli;Lactobacillales;Streptococcaceae;Streptococcus;Streptococcus sp. HSISS3	0	0	0	0	0	0	1	0	1
Bacteria;Bacteria_none;Actinomycetota;Actinomycetes;Propionibacteriales;Propionibacteriaceae;Microlunatus;Microlunatus sagamiharensis	0	0	0	0	0	0	0	1	1
Bacteria;Bacteria_none;Actinomycetota;Actinomycetes;Propionibacteriales;Nocardioidaceae;Nocardioides;Nocardioides sp. LMS-CY	0	0	0	0	1	0	0	0	1
Bacteria;Bacteria_none;Actinomycetota;Actinomycetes;Propionibacteriales;Nocardioidaceae;Nocardioides;Nocardioides sp. InS609-2	0	0	0	0	0	1	0	0	1
Bacteria;Bacteria_none;Bacillota;Clostridia;Eubacteriales;Clostridiaceae;Alkaliphilus;Alkaliphilus metalliredigens	1	0	0	0	0	0	0	0	1
Bacteria;Bacteria_none;Actinomycetota;Actinomycetes;Mycobacteriales;Nocardiaceae;Rhodococcus;Rhodococcus sp. Z13	0	0	0	0	0	1	0	0	1
Bacteria;Bacteria_none;Bacillota;Clostridia;Eubacteriales;Lachnospiraceae;Anaerocolumna;Anaerocolumna chitinilytica	0	0	1	0	0	0	0	0	1
Bacteria;Bacteria_none;Bacillota;Clostridia;Eubacteriales;Lachnospiraceae;Anaeromicropila;Anaeromicropila herbilytica	0	0	0	1	0	0	0	0	1
Bacteria;Bacteria_none;Bacillota;Erysipelotrichia;Erysipelotrichales;Erysipelotrichaceae;Erysipelothrix;Erysipelothrix piscisicarius	0	0	0	0	0	0	0	1	1
Bacteria;Bacteria_none;Bacillota;Clostridia;Eubacteriales;Peptostreptococcaceae;Romboutsia;Romboutsia ilealis	0	0	0	0	0	0	0	1	1
Bacteria;Bacteria_none;Bacillota;Clostridia;Eubacteriales;Peptostreptococcaceae;Tepidibacter;Tepidibacter sp. 8C15b	0	0	0	0	0	0	0	1	1
Bacteria;Bacteria_none;Bacillota;Clostridia;Eubacteriales;Vallitaleaceae;Vallitalea;Vallitalea guaymasensis	0	0	0	0	0	1	0	0	1
Bacteria;Bacteria_none;Bacillota;Clostridia;Halanaerobiales;Halobacteroidaceae;Acetohalobium;Acetohalobium arabaticum	0	0	0	0	0	0	0	1	1
Bacteria;Bacteria_none;Bacillota;Clostridia;Halanaerobiales;Halobacteroidaceae;Halobacteroides;Halobacteroides halobius	0	0	0	0	0	1	0	0	1
Bacteria;Bacteria_none;Bacillota;Clostridia;Thermoanaerobacterales;Thermoanaerobacterales Family III. Incertae Sedis;Caldicellulosiruptor;Caldicellulosiruptor diazotrophicus	0	0	0	0	1	0	0	0	1
Bacteria;Bacteria_none;Bacillota;Clostridia;Thermosediminibacterales;Tepidanaerobacteraceae;Tepidanaerobacter;Tepidanaerobacter acetatoxydans	0	0	0	0	0	0	0	1	1
Bacteria;Bacteria_none;Bacillota;Clostridia;Thermosediminibacterales;Thermosediminibacteraceae;Thermosediminibacter;Thermosediminibacter oceani	0	0	0	0	0	0	0	1	1
Bacteria;Bacteria_none;Bacillota;Erysipelotrichia;Erysipelotrichales;Coprobacillaceae;Thomasclavelia;[Clostridium] innocuum	0	0	0	0	0	0	0	1	1
Bacteria;Bacteria_none;Actinomycetota;Actinomycetes;Mycobacteriales;Nocardiaceae;Nocardia;Nocardia asteroides	0	0	0	0	1	0	0	0	1
Bacteria;Bacteria_none;Bacillota;Erysipelotrichia;Erysipelotrichales;Erysipelotrichaceae;Erysipelothrix;Erysipelothrix larvae	0	0	0	0	0	0	0	1	1
Bacteria;Bacteria_none;Bacillota;Erysipelotrichia;Erysipelotrichales;Erysipelotrichaceae;Longicatena;Longicatena caecimuris	0	0	0	0	0	0	0	1	1
Bacteria;Bacteria_none;Bacillota;Clostridia;Eubacteriales;Lachnospiraceae;Anaerostipes;Anaerostipes caccae	0	0	0	1	0	0	0	0	1
Bacteria;Bacteria_none;Bacillota;Erysipelotrichia;Erysipelotrichales;Turicibacteraceae;Turicibacter;Turicibacter bilis	0	0	0	1	0	0	0	0	1
Bacteria;Bacteria_none;Bacillota;Negativicutes;Acidaminococcales;Acidaminococcaceae;Phascolarctobacterium;Phascolarctobacterium faecium	0	0	0	0	0	0	0	1	1
Bacteria;Bacteria_none;Actinomycetota;Actinomycetes;Mycobacteriales;Mycobacteriaceae;Mycolicibacterium;Mycolicibacterium psychrotolerans	0	0	0	0	0	0	0	1	1
Bacteria;Bacteria_none;Actinomycetota;Actinomycetes;Mycobacteriales;Mycobacteriaceae;Mycolicibacterium;Mycolicibacterium litorale	0	0	0	1	0	0	0	0	1
Bacteria;Bacteria_none;Actinomycetota;Actinomycetes;Mycobacteriales;Mycobacteriaceae;Mycolicibacterium;Mycolicibacterium aurum	0	0	0	0	1	0	0	0	1
Bacteria;Bacteria_none;Bacillota;Negativicutes;Veillonellales;Veillonellaceae;Megasphaera;Megasphaera massiliensis	0	0	0	0	0	0	0	1	1
Bacteria;Bacteria_none;Actinomycetota;Actinomycetes;Mycobacteriales;Mycobacteriaceae;Mycobacterium;Mycobacterium ostraviense	0	0	0	0	0	0	1	0	1
Bacteria;Bacteria_none;Bacillota;Negativicutes;Veillonellales;Veillonellaceae;Veillonella;Veillonella dispar	0	0	0	0	0	0	1	0	1
Bacteria;Bacteria_none;Bacillota;Negativicutes;Veillonellales;Veillonellaceae;Veillonella;Veillonella nakazawae	0	0	0	1	0	0	0	0	1
Bacteria;Bacteria_none;Actinomycetota;Actinomycetes;Mycobacteriales;Mycobacteriaceae;Mycobacterium;Mycobacterium marinum	0	0	0	0	0	0	0	1	1
Bacteria;Bacteria_none;Actinomycetota;Actinomycetes;Mycobacteriales;Mycobacteriaceae;Mycobacterium;Mycobacterium intracellulare	0	0	0	0	0	0	0	1	1
Bacteria;Bacteria_none;Bacillota;Clostridia;Eubacteriales;Peptostreptococcaceae;Peptostreptococcus;Peptostreptococcus sp. CBA3647	0	0	0	0	0	0	0	1	1
Bacteria;Bacteria_none;Bacillota;Clostridia;Eubacteriales;Peptostreptococcaceae;Peptoclostridium;Peptoclostridium acidaminophilum	0	0	0	0	0	1	0	0	1
Bacteria;Bacteria_none;Bacillota;Clostridia;Eubacteriales;Peptostreptococcaceae;Peptacetobacter;Peptacetobacter hiranonis	0	0	0	0	0	0	0	1	1
Bacteria;Bacteria_none;Bacillota;Clostridia;Eubacteriales;Peptostreptococcaceae;Paeniclostridium;Paeniclostridium sordellii	0	0	0	0	1	0	0	0	1
Bacteria;Bacteria_none;Bacillota;Clostridia;Eubacteriales;Lachnospiraceae;Anaerostipes;Anaerostipes hadrus	0	0	0	0	0	0	0	1	1
Bacteria;Bacteria_none;Bacillota;Clostridia;Eubacteriales;Lachnospiraceae;Blautia;Blautia obeum	0	0	0	0	0	0	0	1	1
Bacteria;Bacteria_none;Bacillota;Clostridia;Eubacteriales;Lachnospiraceae;Blautia;Blautia pseudococcoides	0	0	0	0	0	0	0	1	1
Bacteria;Bacteria_none;Bacillota;Clostridia;Eubacteriales;Lachnospiraceae;Butyrivibrio;Butyrivibrio crossotus	0	0	0	0	0	1	0	0	1
Bacteria;Bacteria_none;Bacillota;Clostridia;Eubacteriales;Lachnospiraceae;Enterocloster;Enterocloster bolteae	0	0	0	0	0	0	0	1	1
Bacteria;Bacteria_none;Actinomycetota;Actinomycetes;Mycobacteriales;Nocardiaceae;Rhodococcus;Rhodococcus sp. MTM3W5.2	0	0	1	0	0	0	0	0	1
Bacteria;Bacteria_none;Bacillota;Clostridia;Eubacteriales;Lachnospiraceae;Pseudobutyrivibrio;Pseudobutyrivibrio xylanivorans	0	0	0	0	0	0	0	1	1
Bacteria;Bacteria_none;Bacillota;Clostridia;Eubacteriales;Lachnospiraceae;Tyzzerella;[Clostridium] colinum	0	0	0	0	0	0	0	1	1
Bacteria;Bacteria_none;Bacillota;Clostridia;Eubacteriales;Oscillospiraceae;Acutalibacter;Acutalibacter muris	0	0	0	0	0	0	0	1	1
Bacteria;Bacteria_none;Bacillota;Clostridia;Eubacteriales;Oscillospiraceae;Caproicibacterium;Caproicibacterium sp. BJN0003	0	0	0	1	0	0	0	0	1
Bacteria;Bacteria_none;Bacillota;Clostridia;Eubacteriales;Oscillospiraceae;Dysosmobacter;Dysosmobacter sp. Marseille-Q4140	1	0	0	0	0	0	0	0	1
Bacteria;Bacteria_none;Bacillota;Clostridia;Eubacteriales;Oscillospiraceae;Faecalibacterium;Faecalibacterium prausnitzii	0	0	0	1	0	0	0	0	1
Bacteria;Bacteria_none;Actinomycetota;Actinomycetes;Mycobacteriales;Nocardiaceae;Rhodococcus;Rhodococcus pyridinivorans	0	0	0	0	0	1	0	0	1
Bacteria;Bacteria_none;Actinomycetota;Actinomycetes;Mycobacteriales;Nocardiaceae;Rhodococcus;Rhodococcus opacus	0	0	1	0	0	0	0	0	1
Bacteria;Bacteria_none;Bacillota;Clostridia;Eubacteriales;Oscillospiraceae;Pseudoclostridium;Pseudoclostridium thermosuccinogenes	0	0	1	0	0	0	0	0	1
Bacteria;Bacteria_none;Bacillota;Clostridia;Eubacteriales;Oscillospiraceae;Ruminiclostridium;Ruminiclostridium cellulolyticum	0	0	0	0	0	0	1	0	1
Bacteria;Bacteria_none;Actinomycetota;Actinomycetes;Mycobacteriales;Nocardiaceae;Rhodococcus;Rhodococcus coprophilus	0	0	0	0	0	0	0	1	1
Bacteria;Bacteria_none;Bacillota;Clostridia;Eubacteriales;Oscillospiraceae;Ruminococcus;Ruminococcus bovis	0	0	0	1	0	0	0	0	1
Bacteria;Bacteria_none;Bacillota;Clostridia;Eubacteriales;Peptococcaceae;Candidatus Desulforudis;Candidatus Desulforudis audaxviator	1	0	0	0	0	0	0	0	1
Bacteria;Bacteria_none;Bacillota;Clostridia;Eubacteriales;Peptococcaceae;Dehalobacterium;Dehalobacterium formicoaceticum	0	0	0	0	0	0	1	0	1
Bacteria;Bacteria_none;Bacillota;Clostridia;Eubacteriales;Peptococcaceae;Thermanaerosceptrum;Thermanaerosceptrum fracticalcis	0	0	0	1	0	0	0	0	1
Bacteria;Bacteria_none;Bacillota;Clostridia;Eubacteriales;Peptostreptococcaceae;Clostridioides;Clostridioides sp. ES-W-0016-02	0	0	1	0	0	0	0	0	1
Bacteria;Bacteria_none;Actinomycetota;Actinomycetes;Mycobacteriales;Nocardiaceae;Nocardia;Nocardia farcinica	0	0	0	0	0	0	0	1	1
Bacteria;Bacteria_none;Actinomycetota;Actinomycetes;Pseudonocardiales;Pseudonocardiaceae;Saccharomonospora;Saccharomonospora viridis	0	0	0	0	1	0	0	0	1
Bacteria;Bacteria_none;Actinomycetota;Actinomycetes;Streptosporangiales;Nocardiopsaceae;Streptomonospora;Streptomonospora litoralis	0	0	0	0	0	1	0	0	1
Bacteria;Bacteria_none;Actinomycetota;Actinomycetes;Streptosporangiales;Streptosporangiaceae;Nonomuraea;Nonomuraea coxensis	0	0	0	0	0	1	0	0	1
Bacteria;Bacteria_none;Bacillota;Bacilli;Bacillales;Paenibacillaceae;Paenibacillus;Paenibacillus sp. BIHB4019	0	0	0	0	0	1	0	0	1
Bacteria;Bacteria_none;Bacillota;Bacilli;Bacillales;Paenibacillaceae;Aneurinibacillus;Aneurinibacillus sp. Ricciae_BoGa-3	0	0	0	0	0	1	0	0	1
Bacteria;Bacteria_none;Bacillota;Bacilli;Bacillales;Paenibacillaceae;Cohnella;Cohnella candidum	0	0	0	0	0	1	0	0	1
Bacteria;Bacteria_none;Bacillota;Bacilli;Bacillales;Paenibacillaceae;Paenibacillus;Paenibacillus agaridevorans	0	0	0	1	0	0	0	0	1
Bacteria;Bacteria_none;Bacillota;Bacilli;Bacillales;Paenibacillaceae;Paenibacillus;Paenibacillus cellulosilyticus	0	0	0	0	0	1	0	0	1
Bacteria;Bacteria_none;Bacillota;Bacilli;Bacillales;Paenibacillaceae;Paenibacillus;Paenibacillus cellulositrophicus	0	0	0	1	0	0	0	0	1
Bacteria;Bacteria_none;Bacillota;Bacilli;Bacillales;Bacillaceae;Bacillus;Bacillus sp. N1-1	0	0	0	0	0	1	0	0	1
Bacteria;Bacteria_none;Bacillota;Bacilli;Bacillales;Paenibacillaceae;Paenibacillus;Paenibacillus lautus	0	0	0	0	0	0	0	1	1
Bacteria;Bacteria_none;Bacillota;Bacilli;Bacillales;Paenibacillaceae;Paenibacillus;Paenibacillus naphthalenovorans	0	0	0	0	0	1	0	0	1
Bacteria;Bacteria_none;Bacillota;Bacilli;Bacillales;Paenibacillaceae;Paenibacillus;Paenibacillus pabuli	0	0	0	0	0	0	0	1	1
Bacteria;Bacteria_none;Bacillota;Bacilli;Bacillales;Paenibacillaceae;Paenibacillus;Paenibacillus polymyxa	0	0	0	0	0	0	0	1	1
Bacteria;Bacteria_none;Bacillota;Bacilli;Bacillales;Bacillaceae;Bacillus;Bacillus sp. BD59S	0	0	0	0	0	0	1	0	1
Bacteria;Bacteria_none;Bacillota;Bacilli;Bacillales;Paenibacillaceae;Paenibacillus;Paenibacillus sp. FSL R7-0331	0	0	0	0	1	0	0	0	1
Bacteria;Bacteria_none;Bacillota;Bacilli;Bacillales;Staphylococcaceae;Macrococcus;Macrococcus epidermidis	0	0	0	1	0	0	0	0	1
Bacteria;Bacteria_none;Bacillota;Bacilli;Bacillales;Paenibacillaceae;Paenibacillus;Paenibacillus sp. PAMC21692	1	0	0	0	0	0	0	0	1
Bacteria;Bacteria_none;Bacillota;Bacilli;Bacillales;Paenibacillaceae;Paenibacillus;Paenibacillus sp. PK3_47	0	0	0	0	0	1	0	0	1
Bacteria;Bacteria_none;Bacillota;Bacilli;Bacillales;Paenibacillaceae;Paenibacillus;Paenibacillus sp. URB8-2	1	0	0	0	0	0	0	0	1
Bacteria;Bacteria_none;Bacillota;Bacilli;Bacillales;Paenibacillaceae;Paenibacillus;Paenibacillus sp. YPD9-1	0	0	0	1	0	0	0	0	1
Bacteria;Bacteria_none;Bacillota;Bacilli;Bacillales;Paenibacillaceae;Paenibacillus;Paenibacillus xylanexedens	0	0	0	1	0	0	0	0	1
Bacteria;Bacteria_none;Bacillota;Bacilli;Bacillales;Paenibacillaceae;Paenibacillus;Paenibacillus yonginensis	0	0	1	0	0	0	0	0	1
Bacteria;Bacteria_none;Bacillota;Bacilli;Bacillales;Planococcaceae;Kurthia;Kurthia sp. 11kri321	0	0	0	0	0	0	1	0	1
Bacteria;Bacteria_none;Bacillota;Bacilli;Bacillales;Planococcaceae;Planococcus;Planococcus antarcticus	0	0	0	0	0	0	0	1	1
Bacteria;Bacteria_none;Bacillota;Bacilli;Bacillales;Planococcaceae;Planococcus;Planococcus halocryophilus	0	0	0	0	0	0	1	0	1
Bacteria;Bacteria_none;Bacillota;Bacilli;Bacillales;Planococcaceae;Sporosarcina;Sporosarcina sp. Marseille-Q4063	0	0	0	0	1	0	0	0	1
Bacteria;Bacteria_none;Bacillota;Bacilli;Bacillales;Planococcaceae;Sporosarcina;Sporosarcina sp. resist	0	1	0	0	0	0	0	0	1
Bacteria;Bacteria_none;Bacillota;Bacilli;Bacillales;Bacillaceae;Bacillus;Bacillus sp. Y1	0	0	0	1	0	0	0	0	1
Bacteria;Bacteria_none;Bacillota;Bacilli;Bacillales;Listeriaceae;Listeria;Listeria newyorkensis	0	0	0	1	0	0	0	0	1
Bacteria;Bacteria_none;Bacillota;Bacilli;Bacillales;Listeriaceae;Brochothrix;Brochothrix thermosphacta	0	1	0	0	0	0	0	0	1
Bacteria;Bacteria_none;Bacillota;Bacilli;Bacillales;Bacillaceae;Bacillus;Bacillus tequilensis	0	0	0	0	0	0	0	1	1
Bacteria;Bacteria_none;Bacillota;Bacilli;Bacillales;Bacillaceae;Fictibacillus;Fictibacillus phosphorivorans	0	0	0	0	0	0	1	0	1
Bacteria;Bacteria_none;Bacillota;Bacilli;Bacillales;Bacillaceae;Geobacillus;Geobacillus genomosp. 3	1	0	0	0	0	0	0	0	1
Bacteria;Bacteria_none;Bacillota;Bacilli;Bacillales;Bacillaceae;Halalkalibacterium (ex Joshi et al. 2022);Halalkalibacterium halodurans	0	0	0	0	0	0	0	1	1
Bacteria;Bacteria_none;Bacillota;Bacilli;Bacillales;Bacillaceae;Halobacillus;Halobacillus litoralis	0	0	0	0	0	0	1	0	1
Bacteria;Bacteria_none;Bacillota;Bacilli;Bacillales;Bacillaceae;Lysinibacillus;Lysinibacillus fusiformis	1	0	0	0	0	0	0	0	1
Bacteria;Bacteria_none;Bacillota;Bacilli;Bacillales;Bacillaceae;Lysinibacillus;Lysinibacillus sp. 2017	0	0	0	1	0	0	0	0	1
Bacteria;Bacteria_none;Bacillota;Bacilli;Bacillales;Bacillaceae;Mesobacillus;Mesobacillus sp. S13	0	0	0	0	0	0	0	1	1
Bacteria;Bacteria_none;Bacillota;Bacilli;Bacillales;Bacillaceae;Neobacillus;Neobacillus mesonae	0	0	0	0	0	0	1	0	1
Bacteria;Bacteria_none;Bacillota;Bacilli;Bacillales;Bacillaceae;Neobacillus;Neobacillus sp. Marseille-Q6967	0	0	0	0	1	0	0	0	1
Bacteria;Bacteria_none;Bacillota;Bacilli;Bacillales;Bacillaceae;Niallia;Niallia sp. Man26	0	0	0	0	0	0	1	0	1
Bacteria;Bacteria_none;Bacillota;Bacilli;Bacillales;Bacillaceae;Niallia;Niallia sp. RD1	0	0	0	0	0	0	0	1	1
Bacteria;Bacteria_none;Bacillota;Bacilli;Bacillales;Bacillaceae;Parageobacillus;Parageobacillus toebii	0	0	0	0	0	1	0	0	1
Bacteria;Bacteria_none;Bacillota;Bacilli;Bacillales;Bacillaceae;Peribacillus;Peribacillus simplex	0	0	0	1	0	0	0	0	1
Bacteria;Bacteria_none;Bacillota;Bacilli;Bacillales;Bacillaceae;Priestia;Priestia filamentosa	0	0	0	1	0	0	0	0	1
Bacteria;Bacteria_none;Bacillota;Bacilli;Bacillales;Bacillaceae;Priestia;Priestia koreensis	0	0	0	0	0	0	1	0	1
Bacteria;Bacteria_none;Bacillota;Bacilli;Bacillales;Bacillaceae;Priestia;Priestia megaterium	0	0	0	0	0	0	1	0	1
Bacteria;Bacteria_none;Bacillota;Bacilli;Bacillales;Bacillaceae;Psychrobacillus;Psychrobacillus sp. AK 1817	0	0	1	0	0	0	0	0	1
Bacteria;Bacteria_none;Bacillota;Bacilli;Bacillales;Bacillaceae;Salicibibacter;Salicibibacter halophilus	0	0	0	0	0	0	0	1	1
Bacteria;Bacteria_none;Bacillota;Bacilli;Bacillales;Bacillaceae;Sutcliffiella;Sutcliffiella horikoshii	0	0	0	0	0	0	0	1	1
Bacteria;Bacteria_none;Bacillota;Bacilli;Bacillales;Bacillaceae;Virgibacillus;Virgibacillus dokdonensis	0	0	0	1	0	0	0	0	1
Bacteria;Bacteria_none;Bacillota;Bacilli;Bacillales;Bacillales_Incertae_sedis;Exiguobacterium;Exiguobacterium sp. AT1b	0	0	0	0	0	0	1	0	1
Bacteria;Bacteria_none;Bacillota;Bacilli;Bacillales;Bacillales_Incertae_sedis;Gemella;Gemella morbillorum	0	0	0	0	0	0	0	1	1
Bacteria;Bacteria_none;Bacillota;Bacilli;Bacillales;Bacillaceae;Bacillus;Bacillus thuringiensis	0	0	0	0	0	1	0	0	1
Bacteria;Bacteria_none;Bacillota;Bacilli;Bacillales;Sporolactobacillaceae;Sporolactobacillus;Sporolactobacillus terrae	0	0	0	0	0	0	0	1	1
Bacteria;Bacteria_none;Bacillota;Bacilli;Bacillales;Staphylococcaceae;Mammaliicoccus;Mammaliicoccus stepanovicii	0	0	0	0	1	0	0	0	1
Bacteria;Bacteria_none;Actinomycetota;Actinomycetes;Streptosporangiales;Streptosporangiaceae;Nonomuraea;Nonomuraea sp. ATCC 55076	0	0	0	0	0	1	0	0	1
Bacteria;Bacteria_none;Bacillota;Bacilli;Lactobacillales;Lactobacillaceae;Lactobacillus;Lactobacillus sp. PV034	0	0	0	0	0	0	0	1	1
Bacteria;Bacteria_none;Aquificota;Aquificae;Aquificales;Hydrogenothermaceae;Sulfurihydrogenibium;Sulfurihydrogenibium azorense	0	0	0	0	0	0	0	1	1
Bacteria;Bacteria_none;Aquificota;Aquificae;Aquificales;Hydrogenothermaceae;Persephonella;Persephonella marina	0	0	0	0	0	0	0	1	1
Bacteria;Bacteria_none;Actinomycetota;Thermoleophilia;Solirubrobacterales;Conexibacteraceae;Conexibacter;Conexibacter woesei	0	0	0	0	0	0	0	1	1
Bacteria;Bacteria_none;Bacillota;Bacilli;Lactobacillales;Lactobacillaceae;Lactobacillus;Lactobacillus apis	0	0	0	0	0	1	0	0	1
Bacteria;Bacteria_none;Actinomycetota;Thermoleophilia;Solirubrobacterales;Conexibacteraceae;Conexibacter;Conexibacter sp. DBS9H8	0	0	0	0	0	1	0	0	1
Bacteria;Bacteria_none;Actinomycetota;Thermoleophilia;Miltoncostaeales;Miltoncostaeaceae;Miltoncostaea;Miltoncostaea oceani	0	0	0	0	0	0	0	1	1
Bacteria;Bacteria_none;Actinomycetota;Nitriliruptoria;Egibacterales;Egibacteraceae;Egibacter;Egibacter rhizosphaerae	0	0	0	0	0	0	0	1	1
Bacteria;Bacteria_none;Bacillota;Bacilli;Lactobacillales;Lactobacillaceae;Lactobacillus;Lactobacillus intestinalis	0	0	0	0	0	1	0	0	1
Bacteria;Bacteria_none;Actinomycetota;Coriobacteriia;Coriobacteriales;Coriobacteriaceae;Collinsella;Collinsella sp. zg1085	0	0	0	0	0	0	0	1	1
Bacteria;Bacteria_none;Bacillota;Bacilli;Lactobacillales;Lactobacillaceae;Lactobacillus;Lactobacillus kullabergensis	0	0	0	0	0	1	0	0	1
Bacteria;Bacteria_none;Bacillota;Bacilli;Lactobacillales;Lactobacillaceae;Lactobacillus;Lactobacillus panisapium	0	0	0	0	0	0	0	1	1
Bacteria;Bacteria_none;Actinomycetota;Coriobacteriia;Coriobacteriales;Atopobiaceae;Parafannyhessea;Parafannyhessea umbonata	0	0	0	0	0	0	0	1	1
Bacteria;Bacteria_none;Bacillota;Bacilli;Bacillales;Bacillaceae;Bacillus;Bacillus pumilus	0	0	0	0	0	0	0	1	1
Bacteria;Bacteria_none;Bacillota;Bacilli;Lactobacillales;Lactobacillaceae;Lactobacillus;Lactobacillus ultunensis	0	0	0	0	0	1	0	0	1
Bacteria;Bacteria_none;Bacillota;Bacilli;Lactobacillales;Lactobacillaceae;Latilactobacillus;Latilactobacillus sakei	0	0	0	0	0	0	1	0	1
Bacteria;Bacteria_none;Bacillota;Bacilli;Lactobacillales;Lactobacillaceae;Lentilactobacillus;Lentilactobacillus buchneri	0	0	0	0	0	1	0	0	1
Bacteria;Bacteria_none;Bacillota;Bacilli;Lactobacillales;Lactobacillaceae;Leuconostoc;Leuconostoc citreum	0	1	0	0	0	0	0	0	1
Bacteria;Bacteria_none;Actinomycetota;Coriobacteriia;Coriobacteriales;Atopobiaceae;Leptogranulimonas;Leptogranulimonas caecicola	0	0	0	0	0	0	1	0	1
Bacteria;Bacteria_none;Actinomycetota;Coriobacteriia;Coriobacteriales;Atopobiaceae;Atopobium;Atopobium sp. oral taxon 416	0	0	0	0	0	0	0	1	1
Bacteria;Bacteria_none;Bacillota;Bacilli;Lactobacillales;Lactobacillaceae;Oenococcus;Oenococcus sp. UCMA 16435	0	0	0	0	0	1	0	0	1
Bacteria;Bacteria_none;Bacillota;Bacilli;Lactobacillales;Lactobacillaceae;Pediococcus;Pediococcus pentosaceus	1	0	0	0	0	0	0	0	1
Bacteria;Bacteria_none;Actinomycetota;Actinomycetes;Streptosporangiales;Thermomonosporaceae;Actinomadura;Actinomadura sp. NAK00032	0	1	0	0	0	0	0	0	1
Bacteria;Bacteria_none;Actinomycetota;Actinomycetes;Streptosporangiales;Streptosporangiaceae;Streptosporangium;Streptosporangium sp. 'caverna'	0	0	0	0	0	1	0	0	1
Bacteria;Bacteria_none;Bacillota;Bacilli;Lactobacillales;Streptococcaceae;Lactococcus;Lactococcus taiwanensis	0	0	0	0	0	0	0	1	1
Bacteria;Bacteria_none;Armatimonadetes;Chthonomonadetes;Chthonomonadales;Chthonomonadaceae;Chthonomonas;Chthonomonas calidirosea	0	0	0	0	0	1	0	0	1
Bacteria;Bacteria_none;Bacillota;Bacilli;Bacillales;Alicyclobacillaceae;Alicyclobacillus;Alicyclobacillus dauci	0	0	0	0	0	0	0	1	1
Bacteria;Bacteria_none;Bacillota;Bacilli;Lactobacillales;Lactobacillaceae;Lacticaseibacillus;Lacticaseibacillus sp. KACC 23028	0	0	0	0	0	0	1	0	1
Bacteria;Bacteria_none;Bacillota;Bacilli;Lactobacillales;Lactobacillaceae;Furfurilactobacillus;Furfurilactobacillus rossiae	0	0	0	0	0	0	1	0	1
Bacteria;Bacteria_none;Bacillota;Bacilli;Bacillales;Staphylococcaceae;Staphylococcus;Staphylococcus auricularis	0	0	0	0	0	1	0	0	1
Bacteria;Bacteria_none;Bacillota;Bacilli;Bacillales;Bacillaceae;Bacillus;Bacillus pseudomycoides	0	0	0	0	0	0	1	0	1
Bacteria;Bacteria_none;Bacillota;Bacilli;Bacillales;Staphylococcaceae;Staphylococcus;Staphylococcus condimenti	0	0	0	0	0	1	0	0	1
Bacteria;Bacteria_none;Bacillota;Bacilli;Bacillales;Bacillaceae;Bacillus;Bacillus mycoides	0	0	0	0	0	0	0	1	1
Bacteria;Bacteria_none;Bacillota;Bacilli;Bacillales;Staphylococcaceae;Staphylococcus;Staphylococcus haemolyticus	0	0	0	0	0	0	0	1	1
Bacteria;Bacteria_none;Bacillota;Bacilli;Bacillales;Staphylococcaceae;Staphylococcus;Staphylococcus lugdunensis	0	0	0	0	0	1	0	0	1
Bacteria;Bacteria_none;Bacillota;Bacilli;Bacillales;Staphylococcaceae;Staphylococcus;Staphylococcus pasteuri	0	0	0	1	0	0	0	0	1
Bacteria;Bacteria_none;Bacillota;Bacilli;Bacillales;Bacillaceae;Bacillus;Bacillus luti	1	0	0	0	0	0	0	0	1
Bacteria;Bacteria_none;Bacillota;Bacilli;Bacillales;Staphylococcaceae;Staphylococcus;Staphylococcus sp. IVB6181	0	0	0	0	1	0	0	0	1
Bacteria;Bacteria_none;Bacillota;Bacilli;Bacillales;Staphylococcaceae;Staphylococcus;Staphylococcus warneri	0	0	0	0	0	0	0	1	1
Bacteria;Bacteria_none;Bacillota;Bacilli;Bacillales;Thermoactinomycetaceae;Thermoactinomyces;Thermoactinomyces vulgaris	0	0	0	0	0	0	1	0	1
Bacteria;Bacteria_none;Bacillota;Bacilli;Lactobacillales;Aerococcaceae;Aerococcus;Aerococcus urinae	0	0	0	0	1	0	0	0	1
Bacteria;Bacteria_none;Bacillota;Bacilli;Lactobacillales;Carnobacteriaceae;Dolosigranulum;Dolosigranulum pigrum	0	0	0	0	0	0	0	1	1
Bacteria;Bacteria_none;Bacillota;Bacilli;Lactobacillales;Carnobacteriaceae;Granulicatella;Granulicatella adiacens	0	0	0	0	0	0	1	0	1
Bacteria;Bacteria_none;Bacillota;Bacilli;Bacillales;Bacillaceae;Anaerobacillus;Anaerobacillus isosaccharinicus	0	0	0	0	0	0	0	1	1
Bacteria;Bacteria_none;Bacillota;Bacilli;Lactobacillales;Enterococcaceae;Enterococcus;Enterococcus avium	0	0	0	0	0	0	0	1	1
Bacteria;Bacteria_none;Bacillota;Bacilli;Lactobacillales;Enterococcaceae;Enterococcus;Enterococcus cecorum	0	0	0	0	0	0	1	0	1
Bacteria;Bacteria_none;Bacillota;Bacilli;Bacillales;Bacillaceae;Alkalihalobacillus;Alkalihalobacillus sp. LMS6	0	0	0	0	0	0	0	1	1
Bacteria;Bacteria_none;Bacillota;Bacilli;Bacillales;Bacillaceae;Alkalihalobacillus;Alkalihalobacillus krulwichiae	0	0	0	0	0	0	0	1	1
Bacteria;Bacteria_none;Bacillota;Bacilli;Lactobacillales;Enterococcaceae;Enterococcus;Enterococcus raffinosus	0	0	0	0	0	0	0	1	1
Bacteria;Bacteria_none;Bacillota;Bacilli;Lactobacillales;Enterococcaceae;Vagococcus;Vagococcus zengguangii	0	0	0	0	0	0	0	1	1
Bacteria;Bacteria_none;Bacillota;Bacilli;Lactobacillales;Lactobacillaceae;Bombilactobacillus;Bombilactobacillus thymidiniphilus	0	0	0	0	0	0	0	1	1
Bacteria;Bacteria_none;Bacillota;Bacilli;Bacillales;Alicyclobacillaceae;Alicyclobacillus;Alicyclobacillus fastidiosus	0	0	0	0	1	0	0	0	1
Bacteria;Bacteria_none;Actinomycetota;Actinomycetes;Mycobacteriales;Mycobacteriaceae;Mycobacterium;Mycobacterium heraklionense	0	0	0	0	0	1	0	0	1
Bacteria;Bacteria_none;Bacillota;Tissierellia;Tissierellales;Peptoniphilaceae;Miniphocaeibacter;Miniphocaeibacter halophilus	0	0	0	1	0	0	0	0	1
Bacteria;Bacteria_none;Planctomycetota;Planctomycetia;Pirellulales;Lacipirellulaceae;Aeoliella;Aeoliella mucimassa	0	0	1	0	0	0	0	0	1
Bacteria;Bacteria_none;Candidatus Saccharibacteria;Candidatus Saccharimonadia;Candidatus Nanosynbacterales;Candidatus Nanosynbacteraceae;Candidatus Nanosynbacter;Candidatus Nanosynbacter lyticus	0	0	0	0	0	0	0	1	1
Bacteria;Bacteria_none;Bacteroidota;Sphingobacteriia;Sphingobacteriales;Sphingobacteriaceae;Mucilaginibacter;Mucilaginibacter gotjawali	0	0	0	0	0	0	0	1	1
Bacteria;Bacteria_none;Bacteroidota;Sphingobacteriia;Sphingobacteriales;Sphingobacteriaceae;Mucilaginibacter;Mucilaginibacter xinganensis	0	0	0	0	0	0	1	0	1
Bacteria;Bacteria_none;Bacteroidota;Sphingobacteriia;Sphingobacteriales;Sphingobacteriaceae;Olivibacter;Olivibacter sp. LS-1	0	0	0	0	0	0	1	0	1
Bacteria;Bacteria_none;Bacteroidota;Sphingobacteriia;Sphingobacteriales;Sphingobacteriaceae;Pedobacter;Pedobacter cryoconitis	0	0	0	0	0	0	0	1	1
Bacteria;Bacteria_none;Actinomycetota;Actinomycetes;Micrococcales;Brevibacteriaceae;Brevibacterium;Brevibacterium oceani	0	0	0	0	0	0	0	1	1
Bacteria;Bacteria_none;Bacteroidota;Sphingobacteriia;Sphingobacteriales;Sphingobacteriaceae;Pedobacter;Pedobacter mucosus	0	0	0	1	0	0	0	0	1
Bacteria;Bacteria_none;Bacteroidota;Sphingobacteriia;Sphingobacteriales;Sphingobacteriaceae;Pedobacter;Pedobacter sp. G11	0	0	0	0	0	1	0	0	1
Bacteria;Bacteria_none;Bacteroidota;Sphingobacteriia;Sphingobacteriales;Sphingobacteriaceae;Pedobacter;Pedobacter suwonensis	0	0	0	0	0	0	0	1	1
Bacteria;Bacteria_none;Bacteroidota;Sphingobacteriia;Sphingobacteriales;Sphingobacteriaceae;Sphingobacterium;Sphingobacterium sp. LZ7M1	0	0	0	0	0	0	1	0	1
Bacteria;Bacteria_none;Caldiserica;Caldisericia;Caldisericales;Caldisericaceae;Caldisericum;Caldisericum exile	0	0	0	0	0	0	0	1	1
Bacteria;Bacteria_none;Actinomycetota;Actinomycetes;Micrococcales;Brevibacteriaceae;Brevibacterium;Brevibacterium linens	0	0	0	0	0	0	0	1	1
Bacteria;Bacteria_none;Chlamydiota;Chlamydiia;Chlamydiales;Chlamydiaceae;Chlamydia;Candidatus Chlamydia sanziniae	0	0	0	0	0	0	0	1	1
Bacteria;Bacteria_none;Actinomycetota;Actinomycetes;Micrococcales;Brevibacteriaceae;Brevibacterium;Brevibacterium sp. CS2	0	0	0	0	0	0	0	1	1
Bacteria;Bacteria_none;Chlamydiota;Chlamydiia;Chlamydiales;Chlamydiaceae;Chlamydia;Chlamydia poikilotherma	0	0	0	0	1	0	0	0	1
Bacteria;Bacteria_none;Actinomycetota;Actinomycetes;Micrococcales;Beutenbergiaceae;Beutenbergia;Beutenbergia cavernae	0	0	0	0	0	1	0	0	1
Bacteria;Bacteria_none;Chlamydiota;Chlamydiia;Chlamydiales;Chlamydiaceae;Chlamydiifrater;Chlamydiifrater phoenicopteri	0	0	0	0	1	0	0	0	1
Bacteria;Bacteria_none;Chlorobiota;Chlorobiia;Chlorobiales;Chloroherpetonaceae;Chloroherpeton;Chloroherpeton thalassium	0	0	0	0	0	0	0	1	1
Bacteria;Bacteria_none;Chloroflexota;Anaerolineae;Anaerolineales;Anaerolineaceae;Anaerolinea;Anaerolinea thermophila	0	0	0	0	0	0	0	1	1
Bacteria;Bacteria_none;Chloroflexota;Chloroflexia;Chloroflexales;Chloroflexaceae;Chloroflexus;Chloroflexus aggregans	0	0	0	0	0	0	1	0	1
Bacteria;Bacteria_none;Actinomycetota;Actinomycetes;Kitasatosporales;Streptomycetaceae;Streptomyces;Streptomyces zhihengii	0	0	0	0	0	0	0	1	1
Bacteria;Bacteria_none;Cyanobacteriota;Cyanobacteriota_Incertae_sedis;Cyanobacteriota_Incertae_sedis_Incertae_sedis;Cyanobacteriota_Incertae_sedis_Incertae_sedis_Incertae_sedis;Cyanobacteriota_Incertae_sedis_Incertae_sedis_Incertae_sedis_Incertae_sedis;cyanobacterium endosymbiont of Rhopalodia gibberula	0	0	0	0	0	0	1	0	1
Bacteria;Bacteria_none;Cyanobacteriota;Cyanophyceae;Chroococcales;Geminocystaceae;Cyanobacterium;Cyanobacterium sp. uoEpiScrs1	0	0	0	0	0	0	0	1	1
Bacteria;Bacteria_none;Cyanobacteriota;Cyanophyceae;Gloeobacterales;Gloeobacteraceae;Anthocerotibacter;Anthocerotibacter panamensis	0	1	0	0	0	0	0	0	1
Bacteria;Bacteria_none;Cyanobacteriota;Cyanophyceae;Gloeomargaritales;Gloeomargaritaceae;Gloeomargarita;Gloeomargarita lithophora	0	0	0	0	0	0	0	1	1
Bacteria;Bacteria_none;Bacteroidota;Saprospiria;Saprospirales;Saprospiraceae;Saprospira;Saprospira sp. CCB-QB6	0	0	0	1	0	0	0	0	1
Bacteria;Bacteria_none;Bacteroidota;Flavobacteriia;Flavobacteriales;Weeksellaceae;Faecalibacter;Faecalibacter bovis	0	0	0	0	1	0	0	0	1
Bacteria;Bacteria_none;Bacillota;Tissierellia;Tissierellales;Peptoniphilaceae;Murdochiella;Murdochiella vaginalis	0	0	0	0	0	0	0	1	1
Bacteria;Bacteria_none;Bacteroidota;Flavobacteriia;Flavobacteriales;Flavobacteriaceae;Zunongwangia;Zunongwangia sp. HRR-M8	0	0	0	0	0	0	0	1	1
Bacteria;Bacteria_none;Actinomycetota;Actinomycetes;Micrococcales;Microbacteriaceae;Agromyces;Agromyces sp. CFWR-12	0	0	0	0	0	1	0	0	1
Bacteria;Bacteria_none;Bacteroidota;Flavobacteriia;Flavobacteriales;Flavobacteriaceae;Gramella;Gramella forsetii	0	0	0	0	0	0	0	1	1
Bacteria;Bacteria_none;Bacteroidota;Flavobacteriia;Flavobacteriales;Flavobacteriaceae;Gramella;Gramella salexigens	0	0	0	1	0	0	0	0	1
Bacteria;Bacteria_none;Bacteroidota;Flavobacteriia;Flavobacteriales;Flavobacteriaceae;Lutibacter;Lutibacter profundi	0	0	0	1	0	0	0	0	1
Bacteria;Bacteria_none;Actinomycetota;Actinomycetes;Micrococcales;Dermacoccaceae;Dermacoccus;Dermacoccus nishinomiyaensis	0	0	0	0	1	0	0	0	1
Bacteria;Bacteria_none;Bacteroidota;Flavobacteriia;Flavobacteriales;Flavobacteriaceae;Rasiella;Rasiella rasia	0	0	0	0	0	0	0	1	1
Bacteria;Bacteria_none;Bacteroidota;Flavobacteriia;Flavobacteriales;Flavobacteriaceae;Salegentibacter;Salegentibacter mishustinae	0	0	0	0	0	0	1	0	1
Bacteria;Bacteria_none;Bacteroidota;Flavobacteriia;Flavobacteriales;Flavobacteriaceae;Seonamhaeicola;Seonamhaeicola sp. S2-3	0	0	0	0	1	0	0	0	1
Bacteria;Bacteria_none;Bacteroidota;Flavobacteriia;Flavobacteriales;Flavobacteriaceae;Tenacibaculum;Tenacibaculum jejuense	0	1	0	0	0	0	0	0	1
Bacteria;Bacteria_none;Bacteroidota;Flavobacteriia;Flavobacteriales;Flavobacteriaceae;Tenacibaculum;Tenacibaculum maritimum	0	0	0	1	0	0	0	0	1
Bacteria;Bacteria_none;Bacteroidota;Flavobacteriia;Flavobacteriales;Flavobacteriaceae;Winogradskyella;Winogradskyella schleiferi	0	1	0	0	0	0	0	0	1
Bacteria;Bacteria_none;Bacteroidota;Flavobacteriia;Flavobacteriales;Weeksellaceae;Chryseobacterium;Chryseobacterium balustinum	0	0	0	0	1	0	0	0	1
Bacteria;Bacteria_none;Actinomycetota;Actinomycetes;Micrococcales;Cellulomonadaceae;Cellulomonas;Cellulomonas palmilytica	0	1	0	0	0	0	0	0	1
Bacteria;Bacteria_none;Bacteroidota;Flavobacteriia;Flavobacteriales;Weeksellaceae;Chryseobacterium;Chryseobacterium gleum	0	0	0	0	0	0	1	0	1
Bacteria;Bacteria_none;Bacteroidota;Flavobacteriia;Flavobacteriales;Weeksellaceae;Chryseobacterium;Chryseobacterium manosquense	0	0	1	0	0	0	0	0	1
Bacteria;Bacteria_none;Bacteroidota;Flavobacteriia;Flavobacteriales;Weeksellaceae;Chryseobacterium;Chryseobacterium oranimense	0	0	0	0	0	0	0	1	1
Bacteria;Bacteria_none;Bacteroidota;Flavobacteriia;Flavobacteriales;Weeksellaceae;Chryseobacterium;Chryseobacterium oryzae	0	0	0	0	0	0	1	0	1
Bacteria;Bacteria_none;Bacteroidota;Flavobacteriia;Flavobacteriales;Weeksellaceae;Chryseobacterium;Chryseobacterium sp. G0186	0	1	0	0	0	0	0	0	1
Bacteria;Bacteria_none;Actinomycetota;Actinomycetes;Micrococcales;Cellulomonadaceae;Oerskovia;Oerskovia sp. KBS0722	1	0	0	0	0	0	0	0	1
Bacteria;Bacteria_none;Bacteroidota;Flavobacteriia;Flavobacteriales;Weeksellaceae;Chryseobacterium;Chryseobacterium sp. PCH239	0	1	0	0	0	0	0	0	1
Bacteria;Bacteria_none;Bacteroidota;Flavobacteriia;Flavobacteriales;Weeksellaceae;Chryseobacterium;Chryseobacterium sp. SNU WT5	0	0	0	0	0	0	0	1	1
Bacteria;Bacteria_none;Bacteroidota;Flavobacteriia;Flavobacteriales;Weeksellaceae;Chryseobacterium;Chryseobacterium taklimakanense	0	0	0	0	0	0	0	1	1
Bacteria;Bacteria_none;Actinomycetota;Actinomycetes;Micrococcales;Cellulomonadaceae;Cellulomonas;Cellulomonas wangleii	0	0	0	0	0	0	1	0	1
Bacteria;Bacteria_none;Bacteroidota;Flavobacteriia;Flavobacteriales;Weeksellaceae;Elizabethkingia;Elizabethkingia anophelis	0	0	0	0	0	0	1	0	1
Bacteria;Bacteria_none;Cyanobacteriota;Cyanophyceae;Nostocales;Aphanizomenonaceae;Nodularia;Nodularia sphaerocarpa	0	0	0	0	0	0	0	1	1
Bacteria;Bacteria_none;Bacillota;Bacilli;Bacillales;Bacillaceae;Evansella;Evansella cellulosilytica	0	0	0	0	0	0	1	0	1
Bacteria;Bacteria_none;Cyanobacteriota;Cyanophyceae;Nostocales;Calotrichaceae;Calothrix;Calothrix sp. NIES-3974	0	0	0	0	0	1	0	0	1
Bacteria;Bacteria_none;Mycoplasmatota;Mollicutes;Entomoplasmatales;Spiroplasmataceae;Spiroplasma;Spiroplasma sp. TIUS-1	0	0	0	0	0	1	0	0	1
Bacteria;Bacteria_none;Fusobacteriota;Fusobacteriia;Fusobacteriales;Leptotrichiaceae;Leptotrichia;Leptotrichia shahii	0	0	0	0	1	0	0	0	1
Bacteria;Bacteria_none;Actinomycetota;Actinomycetes;Kitasatosporales;Streptomycetaceae;Streptomyces;Streptomyces sp. NHF165	0	0	0	0	1	0	0	0	1
Bacteria;Bacteria_none;Fusobacteriota;Fusobacteriia;Fusobacteriales;Leptotrichiaceae;Leptotrichia;Leptotrichia wadei	0	0	0	0	0	0	1	0	1
Bacteria;Bacteria_none;Fusobacteriota;Fusobacteriia;Fusobacteriales;Leptotrichiaceae;Sebaldella;Sebaldella termitidis	0	0	0	0	0	1	0	0	1
Bacteria;Bacteria_none;Actinomycetota;Actinomycetes;Kitasatosporales;Streptomycetaceae;Streptomyces;Streptomyces sp. NA04227	0	0	0	0	0	1	0	0	1
Bacteria;Bacteria_none;Actinomycetota;Actinomycetes;Kitasatosporales;Streptomycetaceae;Streptomyces;Streptomyces sp. Mg1	0	0	0	0	0	1	0	0	1
Bacteria;Bacteria_none;Ignavibacteriae;Ignavibacteria;Ignavibacteriales;Ignavibacteriaceae;Ignavibacterium;Ignavibacterium album	0	0	0	0	0	0	0	1	1
Bacteria;Bacteria_none;Mycoplasmatota;Mollicutes;Acholeplasmatales;Acholeplasmataceae;Paracholeplasma;Paracholeplasma brassicae	0	0	0	1	0	0	0	0	1
Bacteria;Bacteria_none;Mycoplasmatota;Mollicutes;Entomoplasmatales;Spiroplasmataceae;Spiroplasma;Spiroplasma clarkii	0	0	0	0	0	0	0	1	1
Bacteria;Bacteria_none;Mycoplasmatota;Mollicutes;Entomoplasmatales;Spiroplasmataceae;Spiroplasma;Spiroplasma endosymbiont of 'Nebria riversi'	0	0	0	0	0	0	0	1	1
Bacteria;Bacteria_none;Mycoplasmatota;Mollicutes;Entomoplasmatales;Spiroplasmataceae;Spiroplasma;Spiroplasma gladiatoris	0	0	0	1	0	0	0	0	1
Bacteria;Bacteria_none;Mycoplasmatota;Mollicutes;Mycoplasmatales;Mycoplasmataceae;Mycoplasma;Mycoplasma capricolum	0	0	0	0	0	1	0	0	1
Bacteria;Bacteria_none;Cyanobacteriota;Cyanophyceae;Nostocales;Hapalosiphonaceae;Fischerella;Fischerella sp. NIES-3754	0	1	0	0	0	0	0	0	1
Bacteria;Bacteria_none;Mycoplasmatota;Mollicutes;Mycoplasmatales;Mycoplasmataceae;Mycoplasma;Mycoplasma haemocanis	0	0	0	1	0	0	0	0	1
Bacteria;Bacteria_none;Mycoplasmatota;Mollicutes;Mycoplasmatales;Mycoplasmataceae;Mycoplasma;Mycoplasma mycoides	0	0	0	0	0	0	1	0	1
Bacteria;Bacteria_none;Mycoplasmatota;Mollicutes;Mycoplasmatales;Mycoplasmataceae;Mycoplasmopsis;Mycoplasmopsis bovis	0	0	0	0	0	1	0	0	1
Bacteria;Bacteria_none;Mycoplasmatota;Mollicutes;Mycoplasmatales;Mycoplasmataceae;Mycoplasmopsis;Mycoplasmopsis cynos	0	0	0	0	0	1	0	0	1
Bacteria;Bacteria_none;Actinomycetota;Actinomycetes;Kitasatosporales;Streptomycetaceae;Streptomyces;Streptomyces sp. MOE7	1	0	0	0	0	0	0	0	1
Bacteria;Bacteria_none;Actinomycetota;Actinomycetes;Kitasatosporales;Streptomycetaceae;Streptomyces;Streptomyces sp. HUAS 15-9	0	0	0	0	1	0	0	0	1
Bacteria;Bacteria_none;Actinomycetota;Actinomycetes;Kitasatosporales;Streptomycetaceae;Streptomyces;Streptomyces sp. HUAS 14-6	0	0	0	0	0	1	0	0	1
Bacteria;Bacteria_none;Mycoplasmatota;Mycoplasmatota_Incertae_sedis;Mycoplasmoidales;Metamycoplasmataceae;Mycoplasmoides;Mycoplasmoides gallisepticum	0	1	0	0	0	0	0	0	1
Bacteria;Bacteria_none;Planctomycetota;Phycisphaerae;Phycisphaerales;Phycisphaeraceae;Poriferisphaera;Poriferisphaera corsica	0	1	0	0	0	0	0	0	1
Bacteria;Bacteria_none;Planctomycetota;Planctomycetia;Gemmatales;Gemmataceae;Gemmata;Gemmata obscuriglobus	0	0	0	0	0	0	1	0	1
Bacteria;Bacteria_none;Planctomycetota;Planctomycetia;Isosphaerales;Isosphaeraceae;Aquisphaera;Aquisphaera giovannonii	0	0	0	0	0	1	0	0	1
Bacteria;Bacteria_none;Fusobacteriota;Fusobacteriia;Fusobacteriales;Fusobacteriaceae;Fusobacterium;Fusobacterium ulcerans	0	0	0	0	1	0	0	0	1
Bacteria;Bacteria_none;Fusobacteriota;Fusobacteriia;Fusobacteriales;Fusobacteriaceae;Fusobacterium;Fusobacterium necrophorum	0	0	0	0	0	0	0	1	1
Bacteria;Bacteria_none;Fusobacteriota;Fusobacteriia;Fusobacteriales;Fusobacteriaceae;Fusobacterium;Fusobacterium hominis	0	0	0	0	0	0	0	1	1
Bacteria;Bacteria_none;Actinomycetota;Actinomycetes;Kitasatosporales;Streptomycetaceae;Streptomyces;Streptomyces sp. S465	1	0	0	0	0	0	0	0	1
Bacteria;Bacteria_none;Cyanobacteriota;Cyanophyceae;Nostocales;Hapalosiphonaceae;Fischerella;Fischerella sp. NIES-4106	0	0	0	1	0	0	0	0	1
Bacteria;Bacteria_none;Cyanobacteriota;Cyanophyceae;Nostocales;Nostocaceae;Nostoc;Nostoc linckia	0	0	0	0	0	0	0	1	1
Bacteria;Bacteria_none;Cyanobacteriota;Cyanophyceae;Nostocales;Nostocaceae;Nostoc;Nostoc sp. ATCC 53789	0	0	0	0	0	1	0	0	1
Bacteria;Bacteria_none;Cyanobacteriota;Cyanophyceae;Nostocales;Nostocaceae;Nostoc;Nostoc sp. C052	0	0	0	0	0	1	0	0	1
Bacteria;Bacteria_none;Cyanobacteriota;Cyanophyceae;Nostocales;Nostocaceae;Nostoc;Nostoc sp. MS1	0	0	0	0	1	0	0	0	1
Bacteria;Bacteria_none;Cyanobacteriota;Cyanophyceae;Nostocales;Nostocaceae;Nostoc;Nostoc sp. UHCC 0870	0	0	0	0	1	0	0	0	1
Bacteria;Bacteria_none;Actinomycetota;Actinomycetes;Kitasatosporales;Streptomycetaceae;Streptomyces;Streptomyces tirandamycinicus	0	0	0	0	0	0	0	1	1
Bacteria;Bacteria_none;Cyanobacteriota;Cyanophyceae;Nostocales;Scytonemataceae;Scytonema;Scytonema sp. NIES-4073	0	0	0	1	0	0	0	0	1
Bacteria;Bacteria_none;Cyanobacteriota;Cyanophyceae;Oscillatoriales;Microcoleaceae;Microcoleus;Microcoleus vaginatus	1	0	0	0	0	0	0	0	1
Bacteria;Bacteria_none;Cyanobacteriota;Cyanophyceae;Oscillatoriales;Microcoleaceae;Planktothrix;Planktothrix agardhii	0	0	0	0	0	1	0	0	1
Bacteria;Bacteria_none;Actinomycetota;Actinomycetes;Kitasatosporales;Streptomycetaceae;Streptomyces;Streptomyces sp. Z423-1	0	0	0	0	0	0	1	0	1
Bacteria;Bacteria_none;Cyanobacteriota;Cyanophyceae;Pseudanabaenales;Leptolyngbyaceae;Leptolyngbya;Leptolyngbya boryana	0	0	0	0	0	1	0	0	1
Bacteria;Bacteria_none;Cyanobacteriota;Cyanophyceae;Pseudanabaenales;Leptolyngbyaceae;Leptolyngbya;Leptolyngbya sp. BL0902	1	0	0	0	0	0	0	0	1
Bacteria;Bacteria_none;Actinomycetota;Actinomycetes;Kitasatosporales;Streptomycetaceae;Streptomyces;Streptomyces sp. WY228	0	0	0	0	0	0	1	0	1
Bacteria;Bacteria_none;Actinomycetota;Actinomycetes;Kitasatosporales;Streptomycetaceae;Streptomyces;Streptomyces sp. T12	0	0	0	0	0	1	0	0	1
Bacteria;Bacteria_none;Cyanobacteriota;Cyanophyceae;Synechococcales;Synechococcaceae;Synechococcus;Synechococcus sp. A15-127	0	0	0	0	0	0	0	1	1
Bacteria;Bacteria_none;Actinomycetota;Actinomycetes;Kitasatosporales;Streptomycetaceae;Streptomyces;Streptomyces sp. S8	0	0	0	0	0	0	0	1	1
Bacteria;Bacteria_none;Cyanobacteriota;Cyanophyceae;Synechococcales;Synechococcaceae;Synechococcus;Synechococcus sp. RS9909	0	0	0	0	0	1	0	0	1
Bacteria;Bacteria_none;Deferribacteres;Deferribacteres;Deferribacterales;Calditerrivibrionaceae;Calditerrivibrio;Calditerrivibrio nitroreducens	0	0	0	0	0	0	0	1	1
Bacteria;Bacteria_none;Deinococcota;Deinococci;Deinococcales;Deinococcaceae;Deinococcus;Deinococcus sp. KNUC1210	1	0	0	0	0	0	0	0	1
Bacteria;Bacteria_none;Deinococcota;Deinococci;Deinococcales;Deinococcaceae;Deinococcus;Deinococcus sp. QL22	0	0	0	0	0	0	0	1	1
Bacteria;Bacteria_none;Deinococcota;Deinococci;Thermales;Thermaceae;Thermus;Thermus thermophilus	0	0	0	0	0	0	0	1	1
Bacteria;Bacteria_none;Dictyoglomi;Dictyoglomia;Dictyoglomales;Dictyoglomaceae;Dictyoglomus;Dictyoglomus thermophilum	0	0	0	0	0	0	0	1	1
Bacteria;Bacteria_none;Bacteroidota;Flavobacteriia;Flavobacteriales;Flavobacteriaceae;Flavobacterium;Flavobacterium sp. N2013	0	0	0	0	0	0	0	1	1
Bacteria;Bacteria_none;Bacteroidota;Flavobacteriia;Flavobacteriales;Flavobacteriaceae;Flavobacterium;Flavobacterium sp. N1994	0	0	0	0	1	0	0	0	1
Bacteria;Bacteria_none;Actinomycetota;Actinomycetes;Micrococcales;Microbacteriaceae;Cryobacterium;Cryobacterium sp. SO1	0	0	0	0	0	0	0	1	1
Bacteria;Bacteria_none;Actinomycetota;Actinomycetes;Micrococcales;Micrococcaceae;Rothia;Rothia aeria	0	0	0	0	0	1	0	0	1
Bacteria;Bacteria_none;Actinomycetota;Actinomycetes;Micromonosporales;Micromonosporaceae;Phytohabitans;Phytohabitans flavus	0	0	0	0	0	0	1	0	1
Bacteria;Bacteria_none;Actinomycetota;Actinomycetes;Micromonosporales;Micromonosporaceae;Micromonospora;Micromonospora viridifaciens	0	0	0	0	0	0	0	1	1
Bacteria;Bacteria_none;Actinomycetota;Actinomycetes;Micromonosporales;Micromonosporaceae;Micromonospora;Micromonospora purpureochromogenes	0	0	0	0	0	0	0	1	1
Bacteria;Bacteria_none;Actinomycetota;Actinomycetes;Micromonosporales;Micromonosporaceae;Micromonospora;Micromonospora inositola	0	0	1	0	0	0	0	0	1
Bacteria;Bacteria_none;Actinomycetota;Actinomycetes;Micromonosporales;Micromonosporaceae;Actinoplanes;Actinoplanes sp. L3-i22	0	0	0	0	0	0	0	1	1
Bacteria;Bacteria_none;Actinomycetota;Actinomycetes;Micrococcales;Tropherymataceae;Tropheryma;Tropheryma whipplei	0	0	0	1	0	0	0	0	1
Bacteria;Bacteria_none;Actinomycetota;Actinomycetes;Micrococcales;Promicromonosporaceae;Xylanimonas;Xylanimonas cellulosilytica	0	0	1	0	0	0	0	0	1
Bacteria;Bacteria_none;Actinomycetota;Actinomycetes;Micrococcales;Promicromonosporaceae;Xylanimonas;Xylanimonas allomyrinae	0	0	0	1	0	0	0	0	1
Bacteria;Bacteria_none;Actinomycetota;Actinomycetes;Micrococcales;Promicromonosporaceae;Isoptericola;Isoptericola variabilis	1	0	0	0	0	0	0	0	1
Bacteria;Bacteria_none;Actinomycetota;Actinomycetes;Micrococcales;Promicromonosporaceae;Isoptericola;Isoptericola dokdonensis	0	0	0	0	0	0	1	0	1
Bacteria;Bacteria_none;Actinomycetota;Actinomycetes;Micrococcales;Ornithinimicrobiaceae;Serinicoccus;Serinicoccus hydrothermalis	0	0	0	0	0	1	0	0	1
Bacteria;Bacteria_none;Actinomycetota;Actinomycetes;Micrococcales;Micrococcaceae;Psychromicrobium;Psychromicrobium lacuslunae	0	0	0	0	0	1	0	0	1
Bacteria;Bacteria_none;Bacteroidota;Bacteroidota_Incertae_sedis;Bacteroidota_Incertae_sedis_Incertae_sedis;Rhodothermaceae;Rhodothermus;Rhodothermus marinus	0	0	0	0	0	0	1	0	1
Bacteria;Bacteria_none;Actinomycetota;Actinomycetes;Micrococcales;Micrococcaceae;Paenarthrobacter;Paenarthrobacter ureafaciens	0	0	0	1	0	0	0	0	1
Bacteria;Bacteria_none;Actinomycetota;Actinomycetes;Micrococcales;Micrococcaceae;Kocuria;Kocuria varians	0	0	0	0	0	0	0	1	1
Bacteria;Bacteria_none;Actinomycetota;Actinomycetes;Micrococcales;Micrococcaceae;Glutamicibacter;Glutamicibacter creatinolyticus	0	0	0	0	0	0	0	1	1
Bacteria;Bacteria_none;Actinomycetota;Actinomycetes;Micrococcales;Micrococcaceae;Arthrobacter;Arthrobacter sp. YA7-1	0	0	0	0	0	0	0	1	1
Bacteria;Bacteria_none;Actinomycetota;Actinomycetes;Micrococcales;Micrococcaceae;Arthrobacter;Arthrobacter sp. KBS0702	0	0	0	0	0	0	1	0	1
Bacteria;Bacteria_none;Actinomycetota;Actinomycetes;Micrococcales;Microbacteriaceae;Rathayibacter;Rathayibacter tanaceti	0	0	0	0	0	1	0	0	1
Bacteria;Bacteria_none;Actinomycetota;Actinomycetes;Micrococcales;Microbacteriaceae;Microbacterium;Microbacterium sp. SSW1-36	0	0	0	0	0	0	1	0	1
Bacteria;Bacteria_none;Actinomycetota;Actinomycetes;Micrococcales;Microbacteriaceae;Microbacterium;Microbacterium sp. NIBRBAC000506063	0	0	0	1	0	0	0	0	1
Bacteria;Bacteria_none;Actinomycetota;Actinomycetes;Micrococcales;Microbacteriaceae;Microbacterium;Microbacterium sp. KUDC0405	0	1	0	0	0	0	0	0	1
Bacteria;Bacteria_none;Bacteroidota;Bacteroidia;Bacteroidales;Tannerellaceae;Parabacteroides;Parabacteroides faecis	0	0	0	0	0	0	0	1	1
Bacteria;Bacteria_none;Bacteroidota;Bacteroidia;Bacteroidales;Tannerellaceae;Tannerella;Tannerella serpentiformis	0	0	0	0	0	0	0	1	1
Bacteria;Bacteria_none;Actinomycetota;Actinomycetes;Mycobacteriales;Corynebacteriaceae;Corynebacterium;Corynebacterium accolens	0	0	0	0	0	0	1	0	1
Bacteria;Bacteria_none;Actinomycetota;Actinomycetes;Mycobacteriales;Corynebacteriaceae;Corynebacterium;Corynebacterium camporealensis	0	0	0	1	0	0	0	0	1
Bacteria;Bacteria_none;Bacteroidota;Bacteroidia;Bacteroidales;Porphyromonadaceae;Porphyromonas;Porphyromonas endodontalis	0	0	0	0	0	0	0	1	1
Bacteria;Bacteria_none;Actinomycetota;Actinomycetes;Mycobacteriales;Corynebacteriaceae;Corynebacterium;Corynebacterium efficiens	0	0	0	0	0	0	0	1	1
Bacteria;Bacteria_none;Actinomycetota;Actinomycetes;Mycobacteriales;Mycobacteriaceae;Mycobacterium;Mycobacterium diernhoferi	0	0	1	0	0	0	0	0	1
Bacteria;Bacteria_none;Actinomycetota;Actinomycetes;Mycobacteriales;Mycobacteriaceae;Mycobacterium;Mycobacterium colombiense	0	0	0	0	1	0	0	0	1
Bacteria;Bacteria_none;Bacillota;Tissierellia;Tissierellales;Peptoniphilaceae;Peptoniphilus;Peptoniphilus sp. CBA3646	0	0	0	0	0	0	0	1	1
Bacteria;Bacteria_none;Actinomycetota;Actinomycetes;Mycobacteriales;Mycobacteriaceae;Mycobacterium;Mycobacterium branderi	0	0	0	0	0	1	0	0	1
Bacteria;Bacteria_none;Bacillota;Tissierellia;Tissierellales;Tepidimicrobiaceae;Keratinibaculum;Keratinibaculum paraultunense	0	0	0	1	0	0	0	0	1
Bacteria;Bacteria_none;Bacillota;Tissierellia;Tissierellales;Thermohalobacteraceae;Caloranaerobacter;Caloranaerobacter azorensis	1	0	0	0	0	0	0	0	1
Bacteria;Bacteria_none;Bacillota;Tissierellia;Tissierellia_Incertae_sedis;Tissierellia_Incertae_sedis_Incertae_sedis;Ezakiella;Ezakiella coagulans	0	0	0	1	0	0	0	0	1
Bacteria;Bacteria_none;Actinomycetota;Actinomycetes;Mycobacteriales;Gordoniaceae;Skermania;Skermania piniformis	0	0	0	0	1	0	0	0	1
Bacteria;Bacteria_none;Actinomycetota;Actinomycetes;Mycobacteriales;Gordoniaceae;Gordonia;Gordonia rubripertincta	0	0	0	0	0	1	0	0	1
Bacteria;Bacteria_none;Actinomycetota;Actinomycetes;Mycobacteriales;Corynebacteriaceae;Corynebacterium;Corynebacterium ureicelerivorans	0	0	1	0	0	0	0	0	1
Bacteria;Bacteria_none;Actinomycetota;Actinomycetes;Mycobacteriales;Corynebacteriaceae;Corynebacterium;Corynebacterium singulare	0	0	0	0	0	0	0	1	1
Bacteria;Bacteria_none;Bacteroidota;Bacteroidia;Bacteroidales;Bacteroidaceae;Bacteroides;Bacteroides faecis	0	0	0	0	0	0	0	1	1
Bacteria;Bacteria_none;Actinomycetota;Actinomycetes;Mycobacteriales;Corynebacteriaceae;Corynebacterium;Corynebacterium simulans	0	0	1	0	0	0	0	0	1
Bacteria;Bacteria_none;Actinomycetota;Actinomycetes;Mycobacteriales;Corynebacteriaceae;Corynebacterium;Corynebacterium resistens	0	0	0	0	1	0	0	0	1
Bacteria;Bacteria_none;Actinomycetota;Actinomycetes;Mycobacteriales;Corynebacteriaceae;Corynebacterium;Corynebacterium macginleyi	0	0	1	0	0	0	0	0	1
Bacteria;Bacteria_none;Actinomycetota;Actinomycetes;Mycobacteriales;Corynebacteriaceae;Corynebacterium;Corynebacterium liangguodongii	0	0	0	0	0	0	0	1	1
Bacteria;Bacteria_none;Bacteroidota;Bacteroidia;Bacteroidales;Bacteroidaceae;Bacteroides;Bacteroides sp. M10	0	0	0	0	0	0	0	1	1
Bacteria;Bacteria_none;Bacteroidota;Bacteroidia;Bacteroidales;Bacteroidaceae;Bacteroides;Bacteroides zoogleoformans	0	0	0	1	0	0	0	0	1
Bacteria;Bacteria_none;Bacteroidota;Bacteroidia;Bacteroidales;Bacteroidaceae;Phocaeicola;Phocaeicola salanitronis	0	0	0	0	0	0	0	1	1
Bacteria;Bacteria_none;Actinomycetota;Actinomycetes;Mycobacteriales;Corynebacteriaceae;Corynebacterium;Corynebacterium genitalium	0	0	0	0	1	0	0	0	1
Bacteria;Bacteria_none;Bacteroidota;Bacteroidia;Bacteroidales;Dysgonomonadaceae;Proteiniphilum;Proteiniphilum propionicum	0	0	0	0	0	0	0	1	1
Bacteria;Bacteria_none;Bacteroidota;Bacteroidia;Bacteroidales;Muribaculaceae;Sodaliphilus;Sodaliphilus pleomorphus	0	0	0	0	0	0	0	1	1
Bacteria;Bacteria_none;Bacteroidota;Bacteroidia;Bacteroidales;Odoribacteraceae;Odoribacter;Odoribacter splanchnicus	0	0	0	0	0	0	0	1	1
Bacteria;Bacteria_none;Bacteroidota;Bacteroidia;Marinilabiliales;Prolixibacteraceae;Maribellus;Maribellus comscasis	0	0	1	0	0	0	0	0	1
Bacteria;Bacteria_none;Bacteroidota;Bacteroidota_Incertae_sedis;Candidatus Sulfidibacteriales;Candidatus Sulfidibacteriales_Incertae_sedis;Candidatus Sulfidibacterium;Candidatus Sulfidibacterium hydrothermale	0	0	0	0	0	0	0	1	1
Bacteria;Bacteria_none;Bacteroidota;Flavobacteriia;Flavobacteriales;Flavobacteriaceae;Flavobacterium;Flavobacterium sp. MDT1-60	0	0	0	0	1	0	0	0	1
Bacteria;Bacteria_none;Actinomycetota;Actinomycetes;Micrococcales;Microbacteriaceae;Frigoribacterium;Frigoribacterium sp. SL97	0	0	0	0	1	0	0	0	1
Bacteria;Bacteria_none;Bacteroidota;Cytophagia;Cytophagales;Spirosomaceae;Dyadobacter;Dyadobacter sp. U1	0	0	0	0	0	1	0	0	1
Bacteria;Bacteria_none;Bacteroidota;Cytophagia;Cytophagales;Spirosomaceae;Emticicia;Emticicia sp. 21SJ11W-3	0	0	0	0	0	0	0	1	1
Bacteria;Bacteria_none;Actinomycetota;Actinomycetes;Micrococcales;Microbacteriaceae;Herbiconiux;Herbiconiux sp. L3-i23	0	0	0	0	0	0	1	0	1
Bacteria;Bacteria_none;Bacteroidota;Flavobacteriia;Flavobacteriales;Blattabacteriaceae;Blattabacterium;Blattabacterium sp. (Nauphoeta cinerea)	0	0	0	0	0	0	0	1	1
Bacteria;Bacteria_none;Bacteroidota;Flavobacteriia;Flavobacteriales;Flavobacteriaceae;Aequorivita;Aequorivita sublithincola	0	0	0	0	0	0	0	1	1
Bacteria;Bacteria_none;Bacteroidota;Flavobacteriia;Flavobacteriales;Flavobacteriaceae;Algibacter;Algibacter sp. L3A6	0	0	0	1	0	0	0	0	1
Bacteria;Bacteria_none;Bacteroidota;Flavobacteriia;Flavobacteriales;Flavobacteriaceae;Antarcticibacterium;Antarcticibacterium sp. 1MA-6-2	0	0	0	0	0	0	0	1	1
Bacteria;Bacteria_none;Bacteroidota;Flavobacteriia;Flavobacteriales;Flavobacteriaceae;Aquimarina;Aquimarina sp. AD10	0	0	1	0	0	0	0	0	1
Bacteria;Bacteria_none;Bacteroidota;Flavobacteriia;Flavobacteriales;Flavobacteriaceae;Aquimarina;Aquimarina sp. Aq107	0	0	0	0	0	1	0	0	1
Bacteria;Bacteria_none;Bacteroidota;Flavobacteriia;Flavobacteriales;Flavobacteriaceae;Aquimarina;Aquimarina sp. BL5	0	0	0	0	0	0	0	1	1
Bacteria;Bacteria_none;Bacteroidota;Flavobacteriia;Flavobacteriales;Flavobacteriaceae;Arenibacter;Arenibacter algicola	0	0	0	0	0	0	0	1	1
Bacteria;Bacteria_none;Bacteroidota;Flavobacteriia;Flavobacteriales;Flavobacteriaceae;Cellulophaga;Cellulophaga omnivescoria	0	0	0	0	0	0	1	0	1
Bacteria;Bacteria_none;Bacteroidota;Chitinophagia;Chitinophagales;Chitinophagaceae;Arachidicoccus;Arachidicoccus soli	0	0	0	0	0	0	0	1	1
Bacteria;Bacteria_none;Bacteroidota;Flavobacteriia;Flavobacteriales;Flavobacteriaceae;Cellulophaga;Cellulophaga sp. HaHaR_3_176	0	0	0	1	0	0	0	0	1
Bacteria;Bacteria_none;Bacteroidota;Flavobacteriia;Flavobacteriales;Flavobacteriaceae;Croceibacter;Croceibacter atlanticus	0	0	0	0	0	0	1	0	1
Bacteria;Bacteria_none;Bacteroidota;Flavobacteriia;Flavobacteriales;Flavobacteriaceae;Flavobacterium;Flavobacterium cerinum	0	0	0	0	1	0	0	0	1
Bacteria;Bacteria_none;Bacteroidota;Flavobacteriia;Flavobacteriales;Flavobacteriaceae;Flavobacterium;Flavobacterium channae	0	0	0	0	0	0	0	1	1
Bacteria;Bacteria_none;Bacteroidota;Flavobacteriia;Flavobacteriales;Flavobacteriaceae;Flavobacterium;Flavobacterium davisii	0	0	0	0	1	0	0	0	1
Bacteria;Bacteria_none;Bacteroidota;Flavobacteriia;Flavobacteriales;Flavobacteriaceae;Flavobacterium;Flavobacterium faecale	0	0	0	0	0	1	0	0	1
Bacteria;Bacteria_none;Bacteroidota;Flavobacteriia;Flavobacteriales;Flavobacteriaceae;Flavobacterium;Flavobacterium haoranii	0	0	0	0	0	0	0	1	1
Bacteria;Bacteria_none;Bacteroidota;Flavobacteriia;Flavobacteriales;Flavobacteriaceae;Flavobacterium;Flavobacterium psychrophilum	0	0	0	0	0	0	0	1	1
Bacteria;Bacteria_none;Bacteroidota;Flavobacteriia;Flavobacteriales;Flavobacteriaceae;Flavobacterium;Flavobacterium sangjuense	0	0	0	0	0	0	0	1	1
Bacteria;Bacteria_none;Actinomycetota;Actinomycetes;Micrococcales;Microbacteriaceae;Curtobacterium;Curtobacterium sp. L6-1	0	0	0	0	0	1	0	0	1
Bacteria;Bacteria_none;Bacteroidota;Flavobacteriia;Flavobacteriales;Flavobacteriaceae;Flavobacterium;Flavobacterium sp. KK2020170	0	0	0	0	0	0	0	1	1
Bacteria;Bacteria_none;Bacteroidota;Cytophagia;Cytophagales;Spirosomaceae;Dyadobacter;Dyadobacter sp. CY22	0	0	0	0	0	1	0	0	1
Bacteria;Bacteria_none;Bacteroidota;Cytophagia;Cytophagales;Reichenbachiellaceae;Reichenbachiella;Reichenbachiella sp. Wsw4-B4	1	0	0	0	0	0	0	0	1
Bacteria;Bacteria_none;Bacteroidota;Cytophagia;Cytophagales;Marivirgaceae;Marivirga;Marivirga tractuosa	0	0	0	1	0	0	0	0	1
Bacteria;Bacteria_none;Bacteroidota;Cytophagia;Cytophagales;Mangrovivirgaceae;Mangrovivirga;Mangrovivirga cuniculi	0	0	0	0	0	0	0	1	1
Bacteria;Bacteria_none;Bacteroidota;Chitinophagia;Chitinophagales;Chitinophagaceae;Ferruginibacter;Ferruginibacter lapsinanis	0	0	0	0	0	0	0	1	1
Bacteria;Bacteria_none;Bacteroidota;Chitinophagia;Chitinophagales;Chitinophagaceae;Niastella;Niastella koreensis	0	0	0	0	0	0	0	1	1
Bacteria;Bacteria_none;Bacteroidota;Chitinophagia;Chitinophagales;Chitinophagaceae;Panacibacter;Panacibacter ginsenosidivorans	0	0	0	0	0	0	1	0	1
Bacteria;Bacteria_none;Bacteroidota;Chitinophagia;Chitinophagales;Chitinophagaceae;Phnomibacter;Phnomibacter ginsenosidimutans	0	0	0	1	0	0	0	0	1
Bacteria;Bacteria_none;Bacteroidota;Cytophagia;Cytophagales;Bernardetiaceae;Bernardetia;Bernardetia litoralis	0	0	0	1	0	0	0	0	1
Bacteria;Bacteria_none;Bacteroidota;Cytophagia;Cytophagales;Cyclobacteriaceae;Echinicola;Echinicola strongylocentroti	0	0	0	0	0	1	0	0	1
Bacteria;Bacteria_none;Bacteroidota;Cytophagia;Cytophagales;Cytophagaceae;Aquirufa;Aquirufa lenticrescens	0	0	0	1	0	0	0	0	1
Bacteria;Bacteria_none;Bacteroidota;Cytophagia;Cytophagales;Cytophagaceae;Cytophaga;Cytophaga hutchinsonii	0	0	0	1	0	0	0	0	1
Bacteria;Bacteria_none;Bacteroidota;Cytophagia;Cytophagales;Cytophagaceae;Spirosoma;Spirosoma endbachense	0	0	0	0	1	0	0	0	1
Bacteria;Bacteria_none;Bacteroidota;Cytophagia;Cytophagales;Cytophagaceae;Spirosoma;Spirosoma sp. KCTC 72228	0	1	0	0	0	0	0	0	1
Bacteria;Bacteria_none;Actinomycetota;Actinomycetes;Micrococcales;Microbacteriaceae;Microbacterium;Microbacterium cremeum	0	0	0	0	0	0	1	0	1
Bacteria;Bacteria_none;Bacteroidota;Cytophagia;Cytophagales;Flammeovirgaceae;Flammeovirga;Flammeovirga pectinis	0	0	0	1	0	0	0	0	1
Archaea;Archaea_none;Crenarchaeota;Thermoprotei;Desulfurococcales;Desulfurococcaceae;Desulfurococcus;Desulfurococcus amylolyticus	0	0	0	0	0	0	0	1	1
Bacteria;Bacteria_none;Bacteroidota;Cytophagia;Cytophagales;Fulvivirgaceae;Fulvivirga;Fulvivirga sp. SS9-22	0	0	0	0	0	0	0	1	1
Bacteria;Bacteria_none;Bacteroidota;Cytophagia;Cytophagales;Fulvivirgaceae;Fulvivirga;Fulvivirga sp. W9P-11	0	0	0	0	1	0	0	0	1
Bacteria;Bacteria_none;Bacteroidota;Cytophagia;Cytophagales;Hymenobacteraceae;Adhaeribacter;Adhaeribacter swui	0	0	0	0	0	0	0	1	1
Bacteria;Bacteria_none;Bacteroidota;Cytophagia;Cytophagales;Hymenobacteraceae;Hymenobacter;Hymenobacter jejuensis	0	0	0	1	0	0	0	0	1
Bacteria;Bacteria_none;Bacteroidota;Cytophagia;Cytophagales;Hymenobacteraceae;Hymenobacter;Hymenobacter sp. 5420S-77	0	0	0	1	0	0	0	0	1
Bacteria;Bacteria_none;Bacteroidota;Cytophagia;Cytophagales;Hymenobacteraceae;Hymenobacter;Hymenobacter sp. PAMC 26628	0	0	0	0	1	0	0	0	1
Bacteria;Bacteria_none;Bacteroidota;Cytophagia;Cytophagales;Hymenobacteraceae;Hymenobacter;Hymenobacter sp. YIM 151858-1	0	0	0	1	0	0	0	0	1
Bacteria;Bacteria_none;Bacteroidota;Cytophagia;Cytophagales;Hymenobacteraceae;Nibribacter;Nibribacter ruber	0	0	1	0	0	0	0	0	1
Bacteria;Bacteria_none;Actinomycetota;Actinomycetes;Micrococcales;Microbacteriaceae;Microbacterium;Microbacterium azadirachtae	0	0	0	0	0	0	0	1	1
Bacteria;Bacteria_none;Bacteroidota;Cytophagia;Cytophagales;Hymenobacteraceae;Rufibacter;Rufibacter tibetensis	0	0	0	0	0	1	0	0	1
Bacteria;Bacteria_none;Bacteroidota;Cytophagia;Cytophagales;Fulvivirgaceae;Chryseolinea;Chryseolinea soli	0	0	0	0	1	0	0	0	1
